NFP2441,0,1,1,0,1,3,7
ADR1517,0,0,1,0,1,2,5
MWB4000,0,0,1,0,1,2,5
MLS2856,0,0,1,0,1,2,5
BTR2026,0,0,0,0,1,1,4
ZCT1009,1,1,1,1,1,5,13
SEM1983,0,0,0,0,0,0,0
BDW1459,0,0,0,0,1,1,4
FAJ3101,0,0,0,0,1,1,4
CLR1239,1,1,1,0,0,3,7
LOP1708,0,1,1,0,1,3,7
GKK2422,1,0,1,0,1,3,9
MYB3817,0,1,1,1,1,4,9
JBO2839,0,0,1,0,1,2,5
JTC0941,0,1,1,0,1,3,7
IKA2925,0,1,1,0,1,3,7
JSN1905,1,1,1,1,1,5,13
JRL2365,0,1,1,0,1,3,7
GJB0850,0,0,1,0,1,2,5
LMD2804,0,0,1,0,1,2,5
KMB3003,0,0,0,0,1,1,4
LWV1525,0,0,1,0,1,2,5
RBB3867,0,1,1,1,1,4,9
ARF0575,0,0,0,0,1,1,4
WSC2981,0,1,1,0,1,3,7
HKT1778,0,1,1,1,1,4,9
MAS3218,0,0,0,0,0,0,0
MJG2304,0,1,1,1,1,4,9
CCH1508,0,0,1,0,1,2,5
HDN2609,0,0,0,0,1,1,4
FCM3926,0,0,1,0,1,2,5
DMR0336,0,0,1,0,1,2,5
XAB0936,0,1,1,0,0,2,3
LCB2041,1,1,1,1,1,5,13
ZJB0552,0,0,0,0,1,1,4
AKP3573,0,0,0,0,0,0,0
JRA0522,0,0,0,0,1,1,4
RLS1738,0,1,1,0,1,3,7
CWK2870,0,0,1,0,1,2,5
BRH1107,0,1,1,0,1,3,7
TEF3555,1,1,1,0,1,4,11
GEH0420,1,1,1,1,1,5,13
VCV2521,0,0,0,0,1,1,4
LJR0253,0,0,0,0,1,1,4
RPH2326,0,1,1,0,1,3,7
FJO1828,0,0,0,0,1,1,4
JIG1936,0,1,1,0,1,3,7
OAS0991,0,1,1,0,1,3,7
CRT2273,1,1,1,0,1,4,11
KGR2815,0,0,1,0,1,2,5
ACH1910,0,1,1,1,1,4,9
WDS2197,0,0,1,0,1,2,5
TJM0328,1,0,0,1,1,3,10
JJS2973,0,1,1,0,1,3,7
UDW0487,0,1,1,1,1,4,9
SHB2106,0,0,0,0,1,1,4
PCT1234,1,1,1,0,0,3,7
KAV2926,0,1,1,0,1,3,7
ADS0763,0,1,1,0,1,3,7
SKG1731,0,0,1,0,1,2,5
ISJ1479,0,0,0,0,1,1,4
CAG2236,0,0,1,0,0,1,1
YKW3832,0,0,1,1,1,3,7
AVC2328,1,1,1,0,1,4,11
CSP2186,0,0,1,0,1,2,5
DBG0477,1,1,1,0,1,4,11
HPR2023,0,0,0,0,0,0,0
HAR3571,0,0,0,0,0,0,0
NJM0440,1,0,0,1,1,3,10
IBW1779,1,1,1,1,1,5,13
BVB1673,1,1,1,0,0,3,7
DDF2937,0,1,1,1,0,3,5
NDH3827,0,1,1,1,1,4,9
NLS1866,0,0,0,0,1,1,4
MKM0647,0,0,0,0,1,1,4
DCR1531,0,0,1,0,1,2,5
BSB3083,0,0,0,0,1,1,4
SLM1119,1,1,1,0,1,4,11
KCO0269,0,0,0,0,1,1,4
HVS1143,0,0,0,0,1,1,4
JRR0829,0,0,0,0,0,0,0
BMF2337,0,1,1,0,1,3,7
JRK2707,0,0,0,0,1,1,4
CEC1352,1,1,1,1,1,5,13
KDB0266,0,0,0,0,1,1,4
MKR2138,0,0,0,0,1,1,4
ALS3440,0,1,1,1,1,4,9
AZG2343,1,1,1,0,0,3,7
RJS0846,0,0,1,0,1,2,5
BRG3267,0,0,1,0,1,2,5
QNW0977,0,1,1,1,1,4,9
CNT0946,0,1,1,0,1,3,7
DMR2518,0,0,0,0,1,1,4
DSB0245,0,0,0,0,1,1,4
LBR1387,1,1,1,0,1,4,11
CKB3645,0,0,1,0,1,2,5
DHG0962,1,1,1,0,1,4,11
HMR0098,0,0,0,0,1,1,4
TLW2668,1,1,1,0,1,4,11
LLH3157,0,0,0,0,1,1,4
WNC0874,0,0,1,0,0,1,1
MNC0433,1,0,0,1,1,3,10
IWG0058,1,0,0,1,1,3,10
LBM3284,0,0,1,0,1,2,5
HZH0297,0,0,1,0,1,2,5
UXC1495,0,0,1,0,1,2,5
EHD1744,0,0,1,0,0,1,1
KMC2028,0,1,1,1,1,4,9
HWV1621,1,1,1,0,0,3,7
EFC1153,0,0,0,0,1,1,4
CGT3148,0,0,0,0,1,1,4
JKC3349,0,0,1,0,1,2,5
RJW1440,0,0,0,0,1,1,4
ELB0033,0,0,1,1,1,3,7
RLP3268,0,0,1,0,1,2,5
WEC3721,1,1,1,0,1,4,11
CRJ3070,1,1,1,1,1,5,13
WRM0515,0,1,1,0,1,3,7
ZNG3404,0,1,1,0,1,3,7
NKV1451,0,0,0,0,1,1,4
GSB0666,0,0,0,0,1,1,4
FCK3307,0,0,1,0,1,2,5
RHD0787,0,0,0,0,1,1,4
MFL0355,1,0,0,1,1,3,10
SMO0458,0,1,1,0,1,3,7
GMF1213,1,1,1,0,1,4,11
JNR2260,1,1,1,0,1,4,11
AAH0721,1,1,1,1,1,5,13
ORB2880,0,1,1,0,1,3,7
BXG3763,0,1,1,0,1,3,7
BKF0427,0,1,1,1,1,4,9
CCW2381,0,0,0,0,1,1,4
CXB2183,0,0,1,0,1,2,5
MDP0161,0,1,1,0,1,3,7
JNP1240,1,1,1,0,0,3,7
ANM0564,0,0,0,0,1,1,4
MCS0512,0,1,1,0,1,3,7
DKD2409,0,0,1,0,0,1,1
SWR3808,0,1,1,1,1,4,9
CWA2549,0,0,0,0,0,0,0
BDK0854,0,0,1,0,1,2,5
BBC3733,0,1,1,0,1,3,7
KHP1043,0,1,1,0,1,3,7
ANC1950,0,0,0,0,1,1,4
ISS0949,0,1,1,0,1,3,7
AEH0187,0,0,0,0,0,0,0
MDD1920,0,1,1,1,1,4,9
DAM0096,0,0,0,0,1,1,4
RAI1483,0,0,0,0,1,1,4
UKC1192,0,0,0,0,1,1,4
SIS3576,1,1,1,0,1,4,11
QJF3038,0,1,1,0,1,3,7
DTW1276,0,0,0,0,1,1,4
KAH2398,0,0,1,0,1,2,5
LPC2011,0,0,0,0,1,1,4
EWA1486,0,0,1,0,1,2,5
HSH0292,1,0,0,1,1,3,10
PCM0609,1,1,1,0,1,4,11
CKB0169,0,0,0,0,1,1,4
SJW3131,0,1,1,0,1,3,7
EKC3706,0,0,1,0,1,2,5
VCV1353,1,1,1,1,1,5,13
HJW2646,0,0,0,0,1,1,4
BQV1308,0,0,0,0,1,1,4
LFR0075,0,1,1,1,1,4,9
CAO3117,0,0,0,0,1,1,4
IMP0960,0,1,1,0,1,3,7
DEN0236,1,1,1,1,1,5,13
HHK0652,0,0,0,0,1,1,4
DNH0308,0,0,1,0,1,2,5
FHA3387,0,1,1,0,1,3,7
MTC0855,0,0,1,0,1,2,5
FMN0013,1,0,0,1,1,3,10
DRB0202,0,0,0,0,1,1,4
DMW2128,0,0,0,0,1,1,4
OKF2007,0,0,0,0,1,1,4
TAW2664,1,1,1,0,1,4,11
CAM1323,0,0,0,0,1,1,4
JCR1536,0,0,1,0,1,2,5
HDL2297,0,1,1,1,1,4,9
SCG2695,0,0,0,0,1,1,4
SKB3336,0,0,1,0,1,2,5
CTP2225,0,0,1,0,0,1,1
MBC0803,0,0,0,0,1,1,4
CHB1062,0,1,1,0,1,3,7
NBT3447,1,1,1,0,1,4,11
TGW2782,0,0,1,0,1,2,5
TEC3006,0,0,0,0,1,1,4
TWH1178,0,0,0,0,1,1,4
SGV2780,0,0,1,0,1,2,5
TAN2642,0,0,0,0,0,0,0
CGB3928,0,0,1,0,1,2,5
MBH3427,1,1,1,1,1,5,13
WNR0661,0,0,0,0,1,1,4
LMA3676,0,0,1,0,1,2,5
ESS3318,0,0,1,0,1,2,5
LFC2015,0,0,0,0,1,1,4
JVS2308,0,1,1,1,1,4,9
DRM2927,0,1,1,0,1,3,7
GKG3414,1,1,1,1,1,5,13
JCF0800,0,0,0,0,0,0,0
NMM1844,0,0,0,0,0,0,0
AFB0904,0,0,1,0,1,2,5
FGN0375,0,1,1,0,1,3,7
ESH2077,0,0,0,0,1,1,4
THM1021,0,1,1,0,1,3,7
TGC1489,0,0,1,0,1,2,5
XKR2059,1,1,1,1,1,5,13
BAO2928,1,1,1,0,0,3,7
MJH3822,0,1,1,1,1,4,9
JAW0551,0,0,0,0,0,0,0
JLM3847,1,1,0,1,0,3,8
SCH1013,0,0,0,0,1,1,4
JBD3707,0,0,1,0,1,2,5
SDW0370,0,0,1,0,1,2,5
PCA3344,0,0,1,0,1,2,5
HTC1750,0,1,1,0,1,3,7
CLG3616,0,0,1,0,1,2,5
RCH3740,0,1,1,0,1,3,7
WNR0091,0,0,0,0,1,1,4
JMG3365,0,1,1,0,1,3,7
FQG2974,0,1,1,0,1,3,7
IMM3253,0,0,1,0,1,2,5
TAH0933,0,1,1,0,1,3,7
ITK2781,0,0,1,0,1,2,5
IOR0152,0,1,1,0,1,3,7
VTK2978,1,1,1,0,1,4,11
KAC2449,0,1,1,1,1,4,9
JUH3378,0,1,1,0,1,3,7
KKD1980,0,0,0,0,1,1,4
DRJ0794,0,0,0,0,1,1,4
JXP3801,0,1,1,1,1,4,9
KVD2453,1,1,1,1,1,5,13
KSV2881,0,1,1,0,1,3,7
VQS3246,0,0,0,0,1,1,4
XCG2316,0,1,1,0,0,2,3
JAS0353,1,0,0,1,1,3,10
USD0600,1,1,1,1,1,5,13
FCS2824,0,0,1,0,1,2,5
QCD0386,0,0,1,0,1,2,5
FMS3285,0,0,1,0,1,2,5
NRN1312,0,0,0,0,1,1,4
UIM2818,0,0,1,0,1,2,5
BBH1056,0,1,1,0,1,3,7
KTC0474,1,1,1,0,1,4,11
ERO2454,1,1,1,1,1,5,13
TKC0514,0,1,1,0,1,3,7
NAR1527,0,0,1,0,1,2,5
JHP1799,1,1,1,0,1,4,11
WLC0115,0,0,0,0,1,1,4
BNS3233,0,0,0,0,1,1,4
SCM0778,0,0,0,0,1,1,4
NEC2446,0,1,1,1,1,4,9
ZLB1878,0,0,0,0,1,1,4
HMA1258,1,1,1,0,1,4,11
SUG0718,1,1,1,1,1,5,13
WDL0140,1,1,1,1,1,5,13
SBT2585,0,0,0,0,1,1,4
GKB1150,0,0,0,0,0,0,0
APM0190,0,0,0,0,1,1,4
JLR3930,0,0,1,0,1,2,5
FAJ3608,0,0,0,0,0,0,0
GMB3703,0,0,1,0,1,2,5
MMR0700,0,0,0,0,1,1,4
IAR1895,0,0,0,0,1,1,4
ORJ1401,0,1,1,1,1,4,9
WAL0050,0,1,1,0,1,3,7
KMR0373,1,0,0,1,1,3,10
KDR3234,0,0,0,0,1,1,4
DSF2557,1,1,1,0,1,4,11
MKW0157,0,1,1,0,1,3,7
SAB3860,0,1,1,0,1,3,7
VLM3572,0,0,0,0,1,1,4
CJC2371,1,1,1,0,1,4,11
FKH0804,0,0,0,0,1,1,4
SEM1862,0,0,0,0,1,1,4
MGG0080,0,1,1,0,1,3,7
AJS3899,0,1,1,1,1,4,9
RMN1355,1,1,1,1,1,5,13
JCW1332,0,0,0,0,1,1,4
TPS1568,0,0,1,0,1,2,5
ERG3905,0,1,1,1,1,4,9
KED1219,1,1,1,1,0,4,9
PPP1295,0,0,0,0,1,1,4
ZKR1397,1,1,1,1,1,5,13
PMG0284,1,0,0,1,1,3,10
CET3786,1,1,1,0,1,4,11
HMC0592,0,1,1,1,1,4,9
GBC0907,1,1,1,0,1,4,11
VWV1249,0,1,1,0,1,3,7
FSP0703,0,0,0,0,1,1,4
LLB3769,0,1,1,0,1,3,7
DDG1703,0,1,1,0,1,3,7
KLH0276,0,0,0,0,1,1,4
WLR0707,0,0,0,0,0,0,0
AAS0144,1,1,1,1,1,5,13
AHD2457,0,1,1,1,1,4,9
NBF3844,1,1,0,1,1,4,12
SCC1896,0,0,0,0,1,1,4
DAD1785,1,1,1,1,0,4,9
BJS0744,1,1,1,1,0,4,9
WBH1861,0,0,0,0,1,1,4
KIG1594,0,1,1,0,1,3,7
RFJ2193,0,0,1,0,1,2,5
EMO0159,0,1,1,0,1,3,7
ASM3925,0,0,1,0,1,2,5
FKM1622,0,1,1,0,1,3,7
ALT1354,1,1,1,1,1,5,13
AVP3044,0,1,1,0,1,3,7
BDV2474,0,0,0,0,1,1,4
ARB3934,0,0,1,0,1,2,5
GCL1782,0,1,1,1,1,4,9
BNS3594,0,0,0,0,1,1,4
ZNB3313,0,0,1,0,1,2,5
AHB0648,0,0,0,0,1,1,4
AGF1810,0,1,1,0,0,2,3
KFB2257,1,1,1,0,0,3,7
EHB0942,1,1,1,0,1,4,11
LCS3042,0,1,1,0,1,3,7
ACR0748,1,1,1,1,1,5,13
CLE3098,0,0,0,0,1,1,4
KOM1306,0,0,0,0,1,1,4
AJG0240,0,1,1,1,0,3,5
GSC0192,0,0,0,0,1,1,4
JTS2090,0,0,0,0,1,1,4
EKB3828,0,1,1,1,1,4,9
CIY1654,1,1,1,0,1,4,11
AEB3574,0,0,0,0,1,1,4
ODS0893,0,0,1,0,1,2,5
BHD0598,1,1,1,0,1,4,11
SIM3373,1,1,1,0,1,4,11
KWD3977,0,0,1,0,1,2,5
ROR3967,0,0,1,0,1,2,5
CTH3020,1,1,0,1,1,4,12
CID3640,0,0,1,0,1,2,5
AYA3962,0,0,1,0,1,2,5
GNB3337,0,0,1,0,0,1,1
BHG3238,0,0,0,0,1,1,4
GPD3917,0,0,1,0,1,2,5
DMH0011,1,0,0,1,1,3,10
GCM1580,0,0,1,0,0,1,1
LJE2413,0,0,1,0,1,2,5
BLS3327,0,0,1,0,1,2,5
AOC0982,0,1,1,1,1,4,9
THW1425,0,0,0,0,1,1,4
WRF3534,0,0,0,0,1,1,4
RAB0455,0,1,1,0,1,3,7
ADS2950,0,1,1,1,0,3,5
UKS1465,0,0,0,0,1,1,4
OCH2853,0,0,1,0,1,2,5
DCG2203,0,0,1,0,1,2,5
ABJ0281,0,0,0,0,0,0,0
ATF3951,0,0,1,0,1,2,5
DBL2605,0,0,0,0,1,1,4
MAK1309,0,0,0,0,1,1,4
EIY2749,0,0,0,0,1,1,4
TBC2256,0,1,1,0,1,3,7
TMB1474,0,0,0,0,1,1,4
ROS2030,1,1,1,1,1,5,13
SWH1053,0,1,1,0,1,3,7
EMK3809,1,1,1,1,1,5,13
ICP3710,0,0,1,0,1,2,5
MBS1375,1,1,1,0,1,4,11
KRN2211,0,0,1,0,1,2,5
JVZ3437,0,1,1,1,1,4,9
CJH0382,0,1,1,0,1,3,7
NHK2846,0,0,1,0,1,2,5
RLK3490,1,1,0,0,1,3,10
NSB1016,0,0,0,0,1,1,4
JRR3014,0,1,1,0,1,3,7
ABW0501,0,1,1,0,1,3,7
SCB1280,0,0,0,0,1,1,4
MDH2713,0,0,0,0,1,1,4
TTD2873,0,0,1,0,1,2,5
WVC3623,0,0,1,0,1,2,5
SMG1268,0,0,0,0,0,0,0
VSJ2569,0,1,1,1,0,3,5
JNG1998,0,0,0,0,1,1,4
TZM0716,1,1,1,1,1,5,13
RKW1754,0,0,1,0,1,2,5
MGB0326,1,0,0,1,1,3,10
SSD3197,1,1,1,1,1,5,13
TVC2918,0,1,1,0,1,3,7
RML2789,0,0,1,0,1,2,5
EHV1237,0,1,1,0,1,3,7
LHH2148,0,0,0,0,1,1,4
PJF2579,0,1,1,1,1,4,9
TDM2658,0,0,0,0,1,1,4
MCQ1546,0,0,1,0,1,2,5
NHY0685,0,0,0,0,1,1,4
KJB3654,0,0,1,0,1,2,5
AME1490,0,0,1,0,0,1,1
BHB2598,0,0,0,0,0,0,0
AAB0398,1,0,0,1,1,3,10
XAL2816,0,0,1,0,1,2,5
KNK1428,0,0,0,0,1,1,4
IGP1784,1,1,1,1,1,5,13
FTF1665,0,1,1,0,1,3,7
WSB1368,0,1,1,0,1,3,7
REM0580,0,0,0,0,0,0,0
FTS0246,0,0,0,0,1,1,4
WHL3282,0,0,1,0,1,2,5
EAM1432,0,0,0,0,1,1,4
TAB3539,0,0,0,0,1,1,4
BAL3618,0,0,1,0,1,2,5
GMI1134,0,0,0,0,1,1,4
DFM2933,1,1,1,0,1,4,11
SZG0325,1,0,0,1,1,3,10
RFS1633,0,1,1,0,1,3,7
CWH3487,1,1,0,1,1,4,12
GRM1511,0,0,1,0,0,1,1
LRG3408,0,1,1,0,1,3,7
OQL3890,1,1,1,1,1,5,13
NHM1805,0,1,1,1,1,4,9
SGC1001,0,1,1,1,1,4,9
DDG1822,1,1,1,0,1,4,11
NSW0122,0,0,0,0,1,1,4
BKS2069,1,1,1,1,1,5,13
DLM2826,0,0,1,0,1,2,5
HAR1101,0,1,1,0,1,3,7
MCS1078,1,1,1,1,1,5,13
EUV1842,0,0,0,0,1,1,4
WKS3265,0,0,1,0,1,2,5
WKT0099,0,0,0,0,1,1,4
ASS0120,0,0,0,0,1,1,4
CHL2644,0,0,0,0,1,1,4
BLH3602,0,0,0,0,1,1,4
BYC3970,0,0,1,0,1,2,5
JHH3462,0,1,1,0,1,3,7
MJA2380,0,0,0,0,1,1,4
BNR3128,1,1,1,0,0,3,7
DZG0889,0,0,1,0,1,2,5
PSD1409,0,0,0,0,1,1,4
MSH2210,0,0,1,0,1,2,5
RTS2009,0,0,0,0,1,1,4
IDB1059,0,1,1,0,1,3,7
OJB1538,0,0,1,0,1,2,5
HBD1371,0,1,1,0,1,3,7
OJG3395,0,1,1,0,0,2,3
IWW0699,0,0,0,0,1,1,4
HJR2127,0,0,0,0,1,1,4
BXG1340,0,0,0,0,1,1,4
KLG0439,1,0,0,1,1,3,10
EKN3760,0,1,1,0,1,3,7
RDB1645,0,1,1,0,1,3,7
ERA0725,1,1,1,0,1,4,11
CNS2548,0,0,0,0,1,1,4
CWT3747,0,1,1,0,1,3,7
TJL3603,0,0,0,0,1,1,4
JHF1356,0,1,1,1,1,4,9
SAS1098,0,1,1,0,1,3,7
TPM0234,0,1,1,1,0,3,5
RRD2697,0,0,0,0,1,1,4
JCJ2572,1,1,1,1,0,4,9
JVC2443,0,1,1,0,0,2,3
JHE3080,0,0,0,0,1,1,4
SJC3900,1,1,1,1,1,5,13
SRP2080,0,0,0,0,1,1,4
RRS2359,0,1,1,0,1,3,7
EPW3971,0,0,1,0,1,2,5
TCH2233,0,0,1,0,1,2,5
PKB2483,0,0,0,0,1,1,4
RSW3232,0,0,0,0,1,1,4
CPC0724,1,1,1,0,1,4,11
BCB0521,0,0,0,0,1,1,4
ATM1615,1,1,1,0,1,4,11
NJO1460,0,0,0,0,1,1,4
BYF3784,0,1,1,0,1,3,7
IIW0036,0,1,1,0,1,3,7
WMM0873,0,0,1,0,0,1,1
DCW1901,0,0,0,0,1,1,4
BDB2163,0,0,1,0,1,2,5
BDP0031,1,1,0,1,1,4,12
JDH1550,0,0,1,0,1,2,5
RCB0302,0,0,1,0,1,2,5
ABM3772,1,1,1,0,1,4,11
ABM3687,0,0,1,0,0,1,1
WMR2723,0,0,0,0,1,1,4
BNW3985,0,0,1,0,1,2,5
MST2486,0,0,0,0,1,1,4
JCH1952,0,0,0,0,1,1,4
YIP1802,0,1,1,0,0,2,3
NSM1464,0,0,0,0,1,1,4
KMW0259,0,0,0,0,1,1,4
JTJ3700,0,0,1,0,1,2,5
PCB1603,1,1,1,0,1,4,11
TCB0550,0,0,0,0,1,1,4
ASS2760,0,0,0,0,1,1,4
ZHB1392,1,1,1,1,1,5,13
IFC0958,1,1,1,0,0,3,7
MLW2240,0,0,1,0,1,2,5
JCB3054,0,1,1,0,1,3,7
GWW3788,1,1,1,0,1,4,11
TRH1083,1,1,1,0,1,4,11
ACH0008,1,0,0,1,1,3,10
CCC0491,1,1,1,0,1,4,11
JOC3621,0,0,1,0,1,2,5
VCH3696,0,0,1,0,1,2,5
IMS0862,0,0,1,0,0,1,1
QRJ0691,0,0,0,0,1,1,4
RLR0365,1,0,0,1,1,3,10
EMC3609,0,0,0,0,1,1,4
HJB0220,1,1,1,1,1,5,13
MEW1406,0,0,0,0,1,1,4
YQB2309,0,1,1,1,0,3,5
KBH3913,0,0,1,0,1,2,5
DQS0752,1,1,1,1,1,5,13
CSP3434,0,1,1,1,1,4,9
LTR1729,0,0,0,0,1,1,4
ANO2653,0,0,0,0,1,1,4
DJB1236,1,1,1,0,0,3,7
HSH3606,0,0,0,0,1,1,4
OGD0015,1,0,0,0,1,2,8
LAF1796,0,1,1,0,1,3,7
KGN0619,0,1,1,0,1,3,7
AXL0479,1,1,1,1,0,4,9
DCF2185,0,0,1,0,1,2,5
SJM3805,0,1,1,1,1,4,9
CAG0888,0,0,1,0,1,2,5
RCF0054,0,0,1,0,1,2,5
JBW2054,0,1,1,1,0,3,5
LSN1672,0,1,1,0,1,3,7
IUT3421,0,1,1,1,1,4,9
JFR3527,0,0,0,0,1,1,4
WDD2677,1,1,1,0,1,4,11
INJ3876,0,1,1,1,0,3,5
THM2665,1,1,1,0,1,4,11
TTR0045,0,1,1,0,1,3,7
MTM1434,0,0,0,0,1,1,4
MMR1695,0,1,1,0,1,3,7
EMO2120,0,0,0,0,1,1,4
XFL1583,0,0,1,0,0,1,1
ISR0021,1,0,0,1,1,3,10
UCG0322,1,0,0,1,1,3,10
LKC1944,0,1,1,0,1,3,7
KQD0274,0,0,0,0,1,1,4
JAY3851,0,1,1,0,1,3,7
FNM1482,0,0,0,0,1,1,4
HAG3196,1,1,1,1,1,5,13
UOM3363,0,1,1,0,1,3,7
JKW0200,0,0,0,0,1,1,4
MKC1094,1,1,1,0,1,4,11
AOP1542,0,0,1,0,1,2,5
AEF2019,0,0,0,0,1,1,4
CRM0139,1,1,1,1,1,5,13
NLN0673,0,0,0,0,1,1,4
GMC0953,0,1,1,0,1,3,7
JOW0688,0,0,0,0,1,1,4
CBH0413,0,1,1,0,0,2,3
DJH1506,0,0,1,0,1,2,5
NCS1854,0,0,0,0,1,1,4
COW3840,0,0,1,0,1,2,5
CBJ2083,0,0,0,0,1,1,4
IKC1205,1,1,1,0,1,4,11
BVD3974,0,0,1,0,1,2,5
SCD3192,1,1,1,1,1,5,13
QAH0048,0,1,1,0,1,3,7
WGF0506,1,1,1,0,1,4,11
SFE0723,1,1,1,1,1,5,13
NBC0607,0,1,1,0,1,3,7
CPT1533,0,0,1,0,1,2,5
SNW0798,0,0,0,0,1,1,4
ASM3771,1,1,1,0,1,4,11
ICF2294,1,1,1,1,1,5,13
CBG1074,1,1,1,1,1,5,13
SBW3023,0,1,1,0,1,3,7
CJC1433,0,0,0,0,1,1,4
JBL2993,0,1,1,0,1,3,7
AIH2535,0,0,0,0,1,1,4
GBH1126,0,0,0,0,1,1,4
LOF3279,0,0,1,0,0,1,1
CNH3475,0,1,1,1,1,4,9
IDH2939,1,1,1,1,1,5,13
RJG2239,0,0,1,0,1,2,5
ATT1191,0,0,0,0,1,1,4
GTH3729,0,1,1,0,1,3,7
BCG1029,0,0,1,0,1,2,5
LCC1108,1,1,1,0,1,4,11
IRP2018,0,0,0,0,1,1,4
JMC2806,0,0,1,0,1,2,5
CKH0799,0,0,0,0,1,1,4
SPP2313,1,1,1,0,1,4,11
LVH1790,1,1,1,1,1,5,13
BTB0489,1,1,1,0,1,4,11
YRW0842,0,0,1,0,1,2,5
LRB0372,1,0,0,1,1,3,10
HMV2340,0,1,1,0,1,3,7
DFP3615,0,0,1,0,1,2,5
HMS3795,1,1,1,0,1,4,11
SKM3058,1,1,1,1,1,5,13
IMN1730,0,0,0,0,1,1,4
TKO0417,1,0,1,0,1,3,9
NGB0066,1,1,1,1,1,5,13
MNT0922,1,1,1,0,1,4,11
FMR0920,0,1,1,0,0,2,3
DGN3358,0,1,1,0,1,3,7
JCC0571,0,0,0,0,1,1,4
IKH3472,0,1,1,1,1,4,9
CCG3254,0,0,1,0,1,2,5
SDC3561,0,0,0,0,0,0,0
JAB2131,0,0,0,0,1,1,4
STR1769,0,1,1,0,1,3,7
YFP2558,0,1,1,0,1,3,7
SAL2493,0,0,0,0,1,1,4
LBC0194,0,0,0,0,1,1,4
NKG2706,0,0,0,0,1,1,4
SDN2932,1,1,1,0,1,4,11
HKD1826,0,0,0,0,1,1,4
KLL3118,0,0,0,0,1,1,4
GJM0838,0,0,1,0,1,2,5
MNV0618,1,1,1,0,1,4,11
YCA2885,1,1,1,0,1,4,11
KSW0206,1,0,0,1,1,3,10
ORB0755,1,1,1,1,0,4,9
CST2863,0,0,1,0,1,2,5
WXH2289,0,1,1,1,1,4,9
BVK1096,1,1,1,0,0,3,7
CTC0859,0,0,1,0,0,1,1
ENM2269,0,1,1,0,1,3,7
IQO1690,1,1,1,0,1,4,11
NGC1617,1,1,1,0,1,4,11
RGB0901,0,0,1,0,1,2,5
BLL3910,0,0,1,0,1,2,5
CGM2036,1,1,1,1,1,5,13
CTH0626,1,1,1,0,1,4,11
MDH0211,1,0,0,1,1,3,10
JEW2035,1,1,1,1,1,5,13
DAB2580,0,1,1,1,1,4,9
MIC2325,0,1,1,0,1,3,7
NBL0182,0,0,0,0,1,1,4
NKD3073,0,0,0,0,1,1,4
JGH0728,0,1,1,0,1,3,7
KNS3380,1,1,1,0,1,4,11
SJB0086,0,1,1,0,1,3,7
TGA2006,0,0,0,0,1,1,4
JCH2505,0,0,0,0,1,1,4
HLD1109,0,1,1,0,1,3,7
CWP1829,0,0,0,0,1,1,4
CTH0915,1,1,1,0,1,4,11
FJC2198,0,0,1,0,1,2,5
MML2045,1,1,1,1,1,5,13
WBM0690,0,0,0,0,1,1,4
KCM3235,0,0,0,0,1,1,4
RJW2318,1,1,1,0,1,4,11
AFF1492,0,0,1,0,1,2,5
ONR3291,0,0,1,0,1,2,5
ATC1587,1,1,1,0,1,4,11
RJG3325,0,0,1,0,1,2,5
GFJ2582,1,1,1,1,1,5,13
CRP1915,1,1,1,1,1,5,13
TPS2595,0,0,0,0,1,1,4
BNH3516,0,1,1,0,1,3,7
MWO0559,0,0,0,0,0,0,0
KOE1033,1,0,1,0,1,3,9
CDE1846,0,0,0,0,1,1,4
STR3896,1,1,1,1,1,5,13
TJE1945,0,1,1,0,1,3,7
DKW1659,0,1,1,0,1,3,7
RBH3142,0,0,0,0,1,1,4
LRV1120,0,1,1,0,1,3,7
ZAR0404,1,0,0,1,1,3,10
MBR3261,0,0,1,0,1,2,5
JBB1875,0,0,0,0,1,1,4
JJM2845,0,0,1,0,1,2,5
AYD2775,0,0,1,0,1,2,5
AIB0553,0,0,0,0,1,1,4
KJP1326,0,0,0,0,0,0,0
ZCM1781,0,1,1,1,0,3,5
IHH2590,0,0,0,0,1,1,4
FBD2277,0,1,1,0,1,3,7
CDB2947,1,1,1,1,1,5,13
NPS1563,0,0,1,0,1,2,5
JET2299,0,1,1,1,1,4,9
LGR3119,0,0,0,0,1,1,4
SXO3514,1,1,1,0,1,4,11
JRB2741,0,0,0,0,1,1,4
BGM1226,0,1,1,1,1,4,9
OHF0078,1,1,1,1,1,5,13
JCH1410,0,0,0,0,1,1,4
NTF1342,0,0,0,0,1,1,4
RCT1697,0,1,1,0,1,3,7
CZT2970,0,1,1,0,1,3,7
DMB2533,0,0,0,0,1,1,4
DAB3255,0,0,1,0,0,1,1
SCJ0179,0,0,0,0,1,1,4
LQW0555,0,0,0,0,1,1,4
KAH1820,1,1,1,0,1,4,11
NJC1951,0,0,0,0,1,1,4
LTF3385,0,1,1,0,1,3,7
HGR0198,0,0,0,0,1,1,4
CGM0035,0,1,1,1,1,4,9
WAM0069,1,1,1,0,1,4,11
APH2985,0,1,1,0,1,3,7
JSJ2743,0,0,0,0,1,1,4
APB1122,0,1,1,0,1,3,7
CAS0391,0,1,1,0,1,3,7
MRB2390,1,1,1,1,1,5,13
TJD0106,0,0,0,0,1,1,4
DNS1758,0,1,1,0,1,3,7
CJM3315,0,0,1,0,1,2,5
EHD0024,1,0,0,1,1,3,10
OKH3777,1,1,1,0,1,4,11
ODB0151,1,1,1,0,1,4,11
MAM2363,0,1,1,0,0,2,3
EGG3374,1,1,1,0,1,4,11
EBS2201,0,0,1,0,1,2,5
INH1250,1,1,1,0,1,4,11
CJW2087,0,0,0,0,1,1,4
LQW1314,0,0,0,0,1,1,4
LRK2426,0,1,1,0,1,3,7
KDC1487,0,0,1,0,1,2,5
PMF0768,0,0,0,0,1,1,4
OWD0981,0,1,1,1,1,4,9
RRH0638,0,1,1,1,0,3,5
MPG1307,0,0,0,0,1,1,4
DAT1981,0,0,0,0,0,0,0
KRB3120,0,0,0,0,1,1,4
AAG3799,1,1,1,0,1,4,11
QSM3147,0,0,0,0,1,1,4
KZG3565,0,0,0,0,1,1,4
IHS0816,0,0,0,0,1,1,4
KVA2944,0,1,1,1,1,4,9
JAF0209,0,0,0,0,1,1,4
NJL0974,0,1,1,1,0,3,5
ABB0300,0,0,1,0,1,2,5
TBW1393,0,1,1,1,1,4,9
CHV0509,0,1,1,0,1,3,7
NTE3084,0,0,0,0,1,1,4
JTJ0597,1,1,1,1,1,5,13
JLC0216,1,1,1,1,1,5,13
LGJ2710,0,0,0,0,1,1,4
MDP1412,0,0,0,0,1,1,4
ABR0397,1,1,1,0,1,4,11
GJS3352,1,1,1,0,1,4,11
BUW2717,0,0,0,0,1,1,4
CJM3543,1,1,1,0,1,4,11
CIR1367,0,1,1,0,1,3,7
CBD3251,0,0,1,0,1,2,5
JCP0028,1,0,0,1,1,3,10
QCN2206,0,0,1,0,0,1,1
JJS2079,0,0,0,0,1,1,4
DPC3722,0,1,1,0,1,3,7
BDH0472,0,1,1,1,1,4,9
TTK2633,0,0,0,0,1,1,4
MHR0581,0,0,0,0,1,1,4
MBL2383,0,1,1,1,1,4,9
IAG2742,0,0,0,0,1,1,4
EAH3550,1,1,1,0,1,4,11
SMG1794,1,1,1,0,1,4,11
EVF1722,0,0,0,0,1,1,4
SIR3201,0,0,0,0,1,1,4
CFP3418,1,1,1,1,1,5,13
ZMB3686,0,0,1,0,1,2,5
ATP2680,0,1,1,0,0,2,3
BRM0143,0,1,1,1,1,4,9
KAM0005,1,0,0,1,1,3,10
JHC3520,1,1,1,0,1,4,11
TLC1147,0,0,0,0,1,1,4
SCD2333,0,1,1,0,1,3,7
BBW0594,1,1,1,1,1,5,13
QLW2245,0,0,1,0,1,2,5
MBW1099,0,1,1,0,1,3,7
AMH1481,0,0,0,0,1,1,4
JRF3424,1,1,1,1,1,5,13
IIW1595,0,1,1,0,1,3,7
WWS0645,0,0,0,0,1,1,4
CDB3222,0,0,0,0,1,1,4
CCD3168,0,0,0,0,0,0,0
BTV0644,0,0,0,0,1,1,4
GLB0419,0,1,1,1,1,4,9
JLW2924,0,1,1,0,1,3,7
FAH1566,0,0,1,0,1,2,5
CNT1188,0,0,0,0,1,1,4
AMJ3174,0,0,0,0,0,0,0
PSH3834,1,1,1,1,1,5,13
CCM3075,0,0,0,0,1,1,4
IPB1935,0,1,1,0,1,3,7
RCG0105,0,0,0,0,1,1,4
LAL1956,0,0,0,0,1,1,4
OHC1892,0,0,0,0,1,1,4
ZNE3451,0,1,1,0,1,3,7
HZA3839,0,0,1,0,1,2,5
AMM3906,1,1,1,1,1,5,13
JRM0871,0,0,1,0,0,1,1
JSC3976,0,0,1,0,0,1,1
OTD1228,1,1,1,1,1,5,13
DMC1766,0,1,1,0,1,3,7
BMM3328,0,0,1,0,1,2,5
GEG2093,0,0,0,0,1,1,4
AYP3586,0,1,1,0,1,3,7
TAC3330,0,0,1,0,1,2,5
CDA2295,0,1,1,1,0,3,5
JRM1303,0,0,0,0,1,1,4
JLF3346,0,0,1,0,1,2,5
FRG1576,0,0,1,0,1,2,5
IBC0377,0,1,1,0,1,3,7
KTW1719,0,0,0,0,1,1,4
ADC1469,0,0,0,0,1,1,4
HLS2098,0,0,0,0,1,1,4
OEN0432,1,0,0,1,1,3,10
REK1037,1,0,1,0,1,3,9
KMW1008,1,1,1,1,1,5,13
PNL0018,1,0,1,0,1,3,9
ZSL2618,0,0,0,0,0,0,0
BCB0909,1,1,1,0,1,4,11
GJS0494,1,1,1,0,1,4,11
KDN1740,1,1,0,1,1,4,12
NLC2601,0,0,0,0,1,1,4
HSK0639,0,1,1,1,1,4,9
TLU1836,0,0,0,0,1,1,4
SLS0834,0,0,0,0,1,1,4
XSF3982,0,0,1,0,1,2,5
EPM3878,1,1,1,1,1,5,13
CNF0212,1,0,0,1,1,3,10
FAD3114,0,0,0,0,1,1,4
CDS3824,0,1,1,1,1,4,9
BMA1411,0,0,0,0,1,1,4
REJ2666,1,1,1,0,1,4,11
CHS2323,1,1,1,0,1,4,11
DSB2463,1,1,1,0,1,4,11
CEM1852,0,0,0,0,1,1,4
JJJ1267,0,0,0,0,1,1,4
GUC0473,0,1,1,1,1,4,9
VTL0314,1,0,0,1,1,3,10
SJN1601,0,1,1,0,1,3,7
GGB3663,0,0,1,0,1,2,5
ZCE3578,1,1,1,0,1,4,11
RQN2039,1,1,1,1,1,5,13
PKH0730,0,1,1,0,0,2,3
KJR3538,0,0,0,0,1,1,4
BPD2437,0,1,1,0,1,3,7
SRN2617,0,0,0,0,1,1,4
CCE0745,1,1,1,1,1,5,13
IOF3298,0,0,1,0,0,1,1
ARH1610,0,1,1,0,1,3,7
USF1753,0,0,1,0,1,2,5
ABM3203,0,0,0,0,1,1,4
NMW0896,0,0,1,0,1,2,5
HNG1909,1,1,1,1,1,5,13
CWR0043,0,1,1,0,1,3,7
CKR2586,0,0,0,0,0,0,0
CLS3806,0,1,1,1,1,4,9
WMA2016,0,0,0,0,1,1,4
CJH3630,0,0,1,0,1,2,5
WAA1816,0,1,1,0,1,3,7
AIT1264,0,0,0,0,1,1,4
JVB3184,0,0,0,0,0,0,0
JCS2391,0,1,1,1,1,4,9
MTB2982,1,1,1,0,1,4,11
JJB0042,1,1,1,0,1,4,11
KBC0578,0,0,0,0,1,1,4
LEP2922,1,1,1,0,1,4,11
YHD0593,1,1,1,1,0,4,9
JLA0030,1,1,0,1,1,4,12
WBS1592,0,1,1,0,1,3,7
IYM3865,0,1,1,1,1,4,9
MJB2167,0,0,1,0,1,2,5
CER0228,1,1,1,0,1,4,11
ARW1507,0,0,1,0,1,2,5
MVS1908,0,1,1,1,1,4,9
KGD3278,0,0,1,0,1,2,5
DKR0027,1,0,0,1,1,3,10
ELR1140,0,0,0,0,1,1,4
DHG1830,0,0,0,0,1,1,4
JRP0250,0,0,0,0,1,1,4
EGC0931,1,1,1,0,1,4,11
OJB1095,0,1,1,0,1,3,7
DRB0756,0,1,1,0,1,3,7
YAS2508,0,0,0,0,1,1,4
SDF3082,0,0,0,0,1,1,4
VRJ0636,0,1,1,1,1,4,9
MQS3541,1,1,1,0,0,3,7
KAD0884,0,0,1,0,1,2,5
RBG3850,0,1,1,0,1,3,7
AKL1305,0,0,0,0,1,1,4
CXM1821,0,1,1,0,1,3,7
FKD2779,0,0,1,0,1,2,5
RBB0585,0,0,0,0,1,1,4
MVO2746,0,0,0,0,1,1,4
JZM1351,0,1,1,1,1,4,9
RXG1504,0,0,1,0,1,2,5
JTM0878,0,0,1,0,1,2,5
HDN1139,0,0,0,0,1,1,4
ARB0208,1,0,1,0,1,3,9
CCF3529,0,0,0,0,1,1,4
BJC0366,1,0,0,1,1,3,10
RVB0303,0,0,1,0,1,2,5
VBA1395,0,1,1,1,1,4,9
HBC0999,1,1,1,1,1,5,13
UME2842,0,0,1,0,1,2,5
GJM0065,1,1,1,0,0,3,7
ARM0771,0,0,0,0,1,1,4
LEC3857,0,1,1,0,1,3,7
NEB0371,1,0,0,1,1,3,10
GDH0108,0,0,0,0,1,1,4
WBS3870,1,1,1,1,1,5,13
RSM1089,1,1,1,0,1,4,11
CCB3943,0,0,1,0,1,2,5
BYL2133,0,0,0,0,1,1,4
WTG2109,0,0,0,0,1,1,4
RSM3742,0,1,1,0,1,3,7
MSR3709,0,0,1,0,1,2,5
NBR3731,1,1,1,0,1,4,11
APP1996,0,0,0,0,1,1,4
CFR1523,0,0,1,0,1,2,5
MOW1104,1,1,1,0,1,4,11
HFF2540,0,0,0,0,1,1,4
YCL0824,0,0,0,0,1,1,4
PLT3283,0,0,1,0,1,2,5
RNC3417,0,1,1,1,0,3,5
MVA2547,0,0,0,0,1,1,4
GCS2218,0,0,1,0,1,2,5
ARG0441,1,0,0,1,1,3,10
JDH3762,0,1,1,0,1,3,7
LER3942,0,0,1,0,1,2,5
IDC2568,1,1,1,0,1,4,11
CGG3388,0,1,1,0,1,3,7
FDD1052,0,1,1,0,1,3,7
TRS3323,0,0,1,0,1,2,5
BBT1948,0,0,0,0,1,1,4
JGW1274,0,0,0,0,0,0,0
CSM1565,0,0,1,0,1,2,5
BGB3045,0,1,1,0,1,3,7
EKV3321,0,0,1,0,1,2,5
WJH3158,0,0,0,0,0,0,0
RVH0535,0,0,0,0,1,1,4
NGP0549,0,0,0,0,1,1,4
NYC2048,0,1,1,1,1,4,9
CMM3674,0,0,1,0,1,2,5
ZOO1613,0,1,1,0,1,3,7
CAV1868,0,0,0,0,1,1,4
YHH2785,0,0,1,0,1,2,5
LED0656,0,0,0,0,1,1,4
AKH1534,0,0,1,0,1,2,5
IHB0288,1,0,0,1,1,3,10
XML3920,0,0,1,0,1,2,5
HYP1591,1,1,1,0,1,4,11
JJL1448,0,0,0,0,1,1,4
NDC0948,0,1,1,0,1,3,7
UEP2013,0,0,0,0,1,1,4
DRF3306,0,0,1,0,1,2,5
MBH0527,0,0,0,0,1,1,4
DSC2208,0,0,1,0,1,2,5
BAC2914,0,1,1,0,0,2,3
VMJ3068,1,1,1,1,1,5,13
QCB1360,0,1,1,0,1,3,7
TBK2860,0,0,1,0,1,2,5
MBF3126,1,1,1,0,1,4,11
KSP1288,0,0,0,0,1,1,4
CRE2652,0,0,0,0,0,0,0
MPH0153,1,1,1,0,1,4,11
SVM0770,0,0,0,0,1,1,4
PTG0587,0,0,0,0,1,1,4
IKP1047,0,1,1,0,0,2,3
RIE2876,0,1,1,0,1,3,7
TDM3135,1,1,1,0,1,4,11
DRW1207,1,1,1,0,1,4,11
HAC1300,0,0,0,0,1,1,4
DTG1294,0,0,0,0,1,1,4
PCB0545,0,0,0,0,1,1,4
LMZ1501,0,0,1,0,1,2,5
CPP0623,0,1,1,0,1,3,7
HHG1038,0,1,1,0,1,3,7
ESB2629,0,0,0,0,1,1,4
AGM3504,0,1,1,0,1,3,7
CAS1017,0,0,1,0,1,2,5
PAF1373,1,1,1,0,1,4,11
SAV3457,0,1,1,0,1,3,7
MUO3601,0,0,0,0,1,1,4
NHP0412,1,1,1,0,1,4,11
WKG0150,1,1,1,1,1,5,13
THC2752,0,0,0,0,1,1,4
LXE2139,0,0,0,0,0,0,0
JLR0313,0,0,1,0,1,2,5
SLB3039,0,1,1,0,1,3,7
NJG3144,0,0,0,0,0,0,0
ETG2821,0,0,1,0,1,2,5
FPM2074,0,0,0,0,1,1,4
DBF3582,0,1,1,0,1,3,7
LCH2740,0,0,0,0,1,1,4
KKL1310,0,0,0,0,1,1,4
MAW0532,0,0,0,0,1,1,4
PCS1747,0,1,1,0,1,3,7
HTR1551,0,0,1,0,1,2,5
DSR3787,1,1,1,0,1,4,11
HDT0242,1,1,1,0,0,3,7
ECS3353,0,1,1,0,1,3,7
LKH2512,0,0,0,0,1,1,4
VDB0247,0,0,0,0,1,1,4
LGL0649,0,0,0,0,1,1,4
CKH2230,0,0,1,0,1,2,5
HJR1160,0,0,0,0,1,1,4
FGG3666,0,0,1,0,1,2,5
AGG3958,0,0,1,0,1,2,5
HAH3895,1,1,1,0,1,4,11
KDC0444,1,0,0,1,1,3,10
JBM2769,0,0,0,0,1,1,4
NCO1443,0,0,0,0,1,1,4
NGW2341,1,1,1,0,1,4,11
DAF3096,0,0,0,0,0,0,0
MAC1404,0,0,0,0,1,1,4
PMM0696,0,0,0,0,1,1,4
BUS1727,0,0,0,0,1,1,4
RDM1174,0,0,0,0,1,1,4
OVM1496,0,0,1,0,1,2,5
JON0788,0,0,0,0,0,0,0
DBB3846,1,1,0,1,1,4,12
KKH2324,0,1,1,0,1,3,7
NCS3715,0,1,1,0,1,3,7
VPS3185,0,0,0,0,1,1,4
LMB1077,0,1,1,1,1,4,9
JKK1422,0,0,0,0,1,1,4
LTW1378,0,1,1,0,1,3,7
LRM1362,1,1,1,0,1,4,11
DKB0260,0,0,0,0,1,1,4
KLP0249,0,0,0,0,1,1,4
RJO1791,1,1,1,1,1,5,13
DER2162,0,0,1,0,1,2,5
ZJS1776,0,1,1,0,1,3,7
RLH1548,0,0,1,0,1,2,5
VKM1515,0,0,1,0,1,2,5
ARK3198,1,1,1,1,1,5,13
ANH2482,0,0,0,0,1,1,4
EJL1075,0,1,1,1,1,4,9
PJM3025,0,0,1,0,0,1,1
MTS0465,0,1,1,0,1,3,7
CIG2684,1,1,1,0,1,4,11
NGA0929,1,1,1,0,1,4,11
ZHM1979,0,0,0,0,1,1,4
CQA3849,1,1,1,0,0,3,7
HDK0634,1,1,1,1,1,5,13
CCF2298,0,1,1,1,1,4,9
LGM1260,1,1,1,0,1,4,11
DHM1476,0,0,0,0,1,1,4
JBL3189,1,1,1,1,1,5,13
SJF3798,1,1,1,0,1,4,11
CDL2145,0,0,0,0,1,1,4
MEV2182,0,0,1,0,0,1,1
PMH3484,0,1,1,0,1,3,7
WKH1787,1,1,1,1,1,5,13
HHM0869,0,0,1,0,1,2,5
AHK1988,0,0,0,0,1,1,4
KDM2836,0,0,1,0,1,2,5
RCF0044,0,1,1,0,1,3,7
AEM0554,0,0,0,0,1,1,4
ALH1872,0,0,0,0,1,1,4
TZM0239,0,1,1,1,1,4,9
TBB1547,0,0,1,0,1,2,5
MWB0710,0,0,0,0,1,1,4
BGW1739,1,1,0,1,1,4,12
MRW2504,0,0,0,0,1,1,4
KDF0876,0,0,1,0,1,2,5
IDL2014,0,0,0,0,1,1,4
TRV2966,0,1,1,0,1,3,7
DAM2954,1,1,1,1,1,5,13
EMC2757,0,0,0,0,1,1,4
BPN3051,0,1,1,0,1,3,7
YDM1720,0,0,0,0,1,1,4
CCL1770,0,1,1,0,1,3,7
CMB3499,0,0,1,0,1,2,5
UKC0543,0,0,0,0,1,1,4
RGB1581,0,0,1,0,1,2,5
LLJ3179,0,0,0,0,0,0,0
NMR2725,0,0,0,0,1,1,4
RKJ3379,1,1,1,0,0,3,7
LTO2217,0,0,1,0,1,2,5
ZRM0694,0,0,0,0,1,1,4
EEC3193,1,1,1,1,1,5,13
SKL0739,0,1,1,1,1,4,9
NIM0052,1,0,0,0,1,2,8
SRM1112,1,1,1,0,1,4,11
RUC1198,0,0,0,0,1,1,4
NIM1630,0,1,1,0,1,3,7
AMS0712,0,0,0,0,1,1,4
SBD1557,0,0,1,0,1,2,5
JBC1916,1,1,1,1,1,5,13
DJB2983,0,1,1,0,0,2,3
JKS2444,1,1,1,1,0,4,9
RPB0029,1,0,0,1,1,3,10
FMC1002,0,1,1,1,1,4,9
KHW2052,0,1,1,1,1,4,9
IFS0793,0,0,0,0,1,1,4
RVR0095,0,0,0,0,1,1,4
FKR3316,0,0,1,0,1,2,5
KCM1893,0,0,0,0,1,1,4
HJG2157,0,0,1,0,1,2,5
KSD1646,1,1,1,0,1,4,11
IWW3319,0,0,1,0,0,1,1
BYS3626,0,0,1,0,1,2,5
GFP2144,0,0,0,0,1,1,4
GCB0201,0,0,0,0,1,1,4
EAH3107,0,0,0,0,1,1,4
HKM3016,0,1,1,0,1,3,7
LRF1572,0,0,1,0,0,1,1
SAD3259,0,0,1,0,1,2,5
VAS3984,0,0,1,0,0,1,1
XCB1390,0,1,1,1,1,4,9
CAR0992,0,1,1,0,1,3,7
DGS1079,0,1,1,0,1,3,7
HJB0286,1,0,0,1,1,3,10
DRN0782,0,0,0,0,1,1,4
BDR0510,0,1,1,0,1,3,7
MAH0438,1,0,0,1,1,3,10
MSM3264,0,0,1,0,1,2,5
MVB3343,0,0,1,0,1,2,5
DSM1286,0,0,0,0,1,1,4
CAC1777,0,1,1,0,1,3,7
WSM2798,0,0,1,0,1,2,5
BWJ0136,1,0,0,1,1,3,10
LTW1441,0,0,0,0,0,0,0
DAM3691,0,0,1,0,1,2,5
ALC1060,0,1,1,0,1,3,7
AJM0345,0,0,1,0,1,2,5
SJS1014,0,0,0,0,1,1,4
KJS0119,0,0,0,0,1,1,4
FDF2135,0,0,0,0,0,0,0
EZB3892,1,1,1,1,1,5,13
KCM2495,0,0,0,0,1,1,4
DJF2576,1,1,1,1,1,5,13
RMP3510,0,1,1,0,0,2,3
CED2356,1,1,1,0,0,3,7
MCM2189,0,0,1,0,1,2,5
DER0400,0,0,1,0,1,2,5
AJB1380,0,1,1,0,1,3,7
NJM3961,0,0,1,0,1,2,5
LGS1976,0,0,0,0,1,1,4
CIG3191,1,1,1,1,1,5,13
TAJ0193,0,0,0,0,1,1,4
YDE3069,0,1,1,1,1,4,9
ALS2596,0,0,0,0,1,1,4
XBW2502,0,0,0,0,1,1,4
DMS3400,0,1,1,0,1,3,7
DRD0097,0,0,0,0,1,1,4
MPS2849,0,0,1,0,1,2,5
IIW0399,1,0,0,1,1,3,10
KCW2117,0,0,0,0,1,1,4
RCH3533,0,0,0,0,1,1,4
MPB2578,1,1,1,1,1,5,13
ICH1478,0,0,0,0,1,1,4
JTN2073,0,0,0,0,1,1,4
ODC0002,1,0,0,1,1,3,10
DBW3679,0,0,1,0,1,2,5
KPN3783,0,1,1,0,1,3,7
KBB0890,0,0,1,0,1,2,5
IIF2584,0,0,0,0,1,1,4
DAR0709,0,0,0,0,1,1,4
MNR1903,1,1,1,1,1,5,13
LKG0937,0,1,1,0,1,3,7
JTV1040,0,1,1,0,1,3,7
DNM0275,0,0,0,0,1,1,4
DMH1232,1,1,1,1,1,5,13
DKE0797,0,0,0,0,1,1,4
SSM3894,1,1,1,1,1,5,13
AEG1121,1,1,1,0,0,3,7
SAM3855,0,1,1,0,1,3,7
CDW0986,1,1,1,1,1,5,13
RJF3299,0,0,1,0,1,2,5
IAM3078,0,0,0,0,1,1,4
GEH3406,0,1,1,0,1,3,7
TKN0812,0,0,0,0,0,0,0
OMB3507,1,1,1,0,1,4,11
JNM0905,0,0,1,0,1,2,5
DMS1977,0,0,0,0,0,0,0
TJP2817,0,0,1,0,1,2,5
EJB1263,1,1,1,0,1,4,11
VJB1928,0,1,1,1,1,4,9
TIE1175,0,0,0,0,1,1,4
SYF3607,0,0,0,0,1,1,4
EJH2799,0,0,1,0,1,2,5
HAR3632,0,0,1,0,1,2,5
EKB0825,0,0,0,0,1,1,4
JKG0944,0,1,1,0,1,3,7
SSO2406,1,1,0,1,1,4,12
SFC2336,0,1,1,0,0,2,3
DSB0307,0,0,1,0,1,2,5
GAH1760,0,1,1,0,1,3,7
XTB2372,1,1,1,0,1,4,11
CHM1561,0,0,1,0,1,2,5
MKH1959,0,0,0,0,1,1,4
KZK2058,1,1,1,1,1,5,13
HAP3738,1,1,1,0,1,4,11
CHW2893,0,1,1,0,1,3,7
JNS3342,0,0,1,0,1,2,5
LNV0271,0,0,0,0,0,0,0
KCC3658,0,0,1,0,1,2,5
HAF0394,1,1,1,0,1,4,11
PKB2732,0,0,0,0,1,1,4
MRW3143,0,0,0,0,1,1,4
CJB3470,0,1,1,0,1,3,7
SMN1103,1,1,1,0,1,4,11
AJH2110,0,0,0,0,1,1,4
PKR1145,0,0,0,0,1,1,4
ERD1235,0,1,1,0,1,3,7
HZD0429,1,0,0,1,1,3,10
JCL0446,1,1,0,1,1,4,12
HNC0074,0,1,1,1,1,4,9
KST0924,0,1,1,0,1,3,7
KAC1774,0,1,1,0,1,3,7
WCP2123,0,0,0,0,1,1,4
DRH3557,0,0,0,0,1,1,4
BGS0751,0,1,1,1,1,4,9
KEM1208,1,1,1,0,0,3,7
CAG1644,0,1,1,0,1,3,7
LNA2543,0,0,0,0,1,1,4
KOR1163,0,0,0,0,1,1,4
RJA0402,1,0,0,1,1,3,10
ACJ0014,1,0,0,0,1,2,8
NCV0758,1,1,1,0,0,3,7
MCR3885,0,1,1,1,1,4,9
RTD0762,1,1,1,0,1,4,11
BCH1656,0,1,1,0,1,3,7
ALD3508,0,1,1,0,1,3,7
BHG0258,0,0,0,0,0,0,0
BCH1138,0,0,0,0,1,1,4
MTP2675,1,1,1,0,1,4,11
CTJ2794,0,0,1,0,1,2,5
RCF2057,1,1,1,0,1,4,11
IPS0385,0,1,1,0,0,2,3
JRR0769,0,0,0,0,1,1,4
CJS1932,1,1,1,1,1,5,13
FYP1187,0,0,0,0,1,1,4
ETB0950,0,1,1,0,1,3,7
HJH2588,0,0,0,0,1,1,4
APC3043,0,1,1,0,1,3,7
ECA0976,0,1,1,1,1,4,9
DSD1293,0,0,0,0,1,1,4
WAH2778,0,0,1,0,1,2,5
RGB1346,1,1,1,1,1,5,13
IRP3916,0,0,1,0,1,2,5
DIP3310,0,0,1,0,1,2,5
HID1899,0,0,0,0,1,1,4
SCM2538,0,0,0,0,1,1,4
DAB0166,1,1,1,1,1,5,13
FGH1958,0,0,0,0,1,1,4
DSM2400,0,0,1,0,1,2,5
NHW0864,0,0,1,0,1,2,5
KPS0895,0,0,1,0,1,2,5
CJF1934,1,1,1,0,0,3,7
WSH1130,0,0,0,0,1,1,4
MAG2667,1,1,1,0,0,3,7
CND3037,0,1,1,0,1,3,7
HBM2126,0,0,0,0,1,1,4
ATD0146,0,1,1,1,1,4,9
VAB1526,0,0,1,0,1,2,5
ZCS0012,1,0,0,1,1,3,10
JMB1651,1,1,1,0,1,4,11
ECB1341,0,0,0,0,1,1,4
XHR2377,0,1,1,0,1,3,7
JQS2908,0,1,1,0,1,3,7
BBH3587,0,1,1,0,1,3,7
BXR3536,0,0,0,0,1,1,4
ABM3776,0,1,1,0,1,3,7
WDH0910,1,1,1,0,1,4,11
KMD3062,1,1,1,1,0,4,9
KCM1858,0,0,0,0,1,1,4
MMB2285,0,1,1,1,1,4,9
LGS3477,0,1,1,1,1,4,9
JGR3488,1,1,0,0,1,3,10
VAR3559,0,0,0,0,1,1,4
BCC2536,0,0,0,0,0,0,0
KOE0908,0,1,1,0,1,3,7
BBT0062,1,1,1,0,1,4,11
WEB3897,1,1,1,1,1,5,13
PGS3797,1,1,1,0,1,4,11
AAW0894,0,0,1,0,1,2,5
DIR3921,0,0,1,0,1,2,5
ECB1683,0,1,1,0,1,3,7
CRC0595,1,1,1,0,1,4,11
DWB0238,1,1,1,1,1,5,13
IQR2187,0,0,1,0,1,2,5
NTC2663,0,0,0,0,1,1,4
STK2397,0,0,1,0,1,2,5
GAA3681,0,0,1,0,1,2,5
FCB0563,0,0,0,0,1,1,4
MKM1993,0,0,0,0,1,1,4
JYB0262,0,0,0,0,1,1,4
MDG0019,1,0,0,1,1,3,10
NGS2820,0,0,1,0,0,1,1
SBT2281,0,1,1,0,1,3,7
JLR0632,1,1,1,0,1,4,11
KCW3064,1,1,1,1,1,5,13
PLJ1771,0,1,1,0,0,2,3
GOB3528,0,0,0,0,1,1,4
JIB2606,0,0,0,0,1,1,4
BZB3532,0,0,0,0,1,1,4
DKR0860,0,0,1,0,1,2,5
JMC2911,0,1,1,0,1,3,7
GBB3816,1,1,1,1,1,5,13
LSC3979,0,0,1,0,1,2,5
BVC0009,1,0,0,1,1,3,10
FRB3653,0,0,1,0,1,2,5
ILH0248,0,0,0,0,1,1,4
EKH2084,0,0,0,0,1,1,4
KEM0113,0,0,0,0,1,1,4
PPG2889,0,1,1,0,1,3,7
ACC2773,0,0,0,0,1,1,4
BEB1022,0,1,1,0,1,3,7
QNG2121,0,0,0,0,1,1,4
MDH1924,1,1,1,1,1,5,13
CNR1031,0,1,1,0,1,3,7
RSR2681,1,1,1,0,1,4,11
EAL3873,1,1,1,1,0,4,9
GCH0735,1,1,1,1,1,5,13
KEM2934,1,1,1,1,1,5,13
XKL1317,0,0,0,0,1,1,4
GAP0715,1,1,1,1,1,5,13
KBP0384,1,1,1,0,1,4,11
MLF2319,0,1,1,0,1,3,7
SPW0753,1,1,1,1,1,5,13
TVS0520,0,1,1,0,1,3,7
ACA3252,0,0,1,0,1,2,5
ENR1304,0,0,0,0,1,1,4
CKP0265,0,0,0,0,1,1,4
GLF0226,1,1,1,1,1,5,13
ABC3523,0,0,0,0,1,1,4
MWH1018,0,0,1,0,1,2,5
FDT0213,1,0,0,1,1,3,10
LPW0767,0,0,0,0,1,1,4
KEO0131,1,0,1,0,1,3,9
CDS1579,0,0,1,0,1,2,5
BGK0603,1,1,1,0,1,4,11
TWM2199,0,0,1,0,1,2,5
WAW0422,0,1,1,1,1,4,9
MNP0955,0,1,1,0,1,3,7
KRC2935,1,1,1,1,0,4,9
DMC1438,0,0,0,0,1,1,4
TNS1233,0,1,1,1,1,4,9
GRA0329,1,0,0,1,1,3,10
DAH3331,0,0,1,0,1,2,5
BRM0843,0,0,1,0,1,2,5
SYM2379,0,0,0,0,1,1,4
ASP2895,1,1,1,0,1,4,11
MDG2418,0,0,1,0,1,2,5
BJW3558,0,0,0,0,1,1,4
UMM3017,1,1,0,1,1,4,12
DOB2696,0,0,0,0,1,1,4
BCW3480,0,0,1,0,1,2,5
HAF1891,0,0,0,0,0,0,0
DLG2673,1,1,1,0,1,4,11
SSH1845,0,0,0,0,1,1,4
ZDH2905,0,1,1,0,1,3,7
BEH2967,0,1,1,0,1,3,7
RAF3369,1,1,1,0,0,3,7
JNC2650,0,0,0,0,1,1,4
FDS0810,0,0,0,0,1,1,4
KNR3837,0,0,1,0,1,2,5
AKB2312,0,1,1,1,1,4,9
LGS1812,0,1,1,0,1,3,7
WFH2830,0,0,1,0,1,2,5
PIP3915,0,0,1,0,1,2,5
JAA0897,0,0,1,0,1,2,5
AJM2385,0,0,0,0,1,1,4
YSH0145,0,0,1,1,1,3,7
DPM2971,0,1,1,0,0,2,3
KZM2602,0,0,0,0,1,1,4
SJW0184,0,0,0,0,1,1,4
FCM2190,0,0,1,0,1,2,5
MKD1004,0,0,0,0,1,1,4
RJP1091,1,1,1,0,1,4,11
AGB3303,0,0,1,0,1,2,5
SFL0092,0,0,0,0,1,1,4
HJV1586,0,1,1,0,1,3,7
JTH0719,1,1,1,1,1,5,13
MDS0285,0,0,1,0,1,2,5
NKC3652,0,0,1,0,0,1,1
BOR2387,0,0,0,0,1,1,4
ATH0720,0,1,1,1,1,4,9
MHH2192,0,0,1,0,1,2,5
VTD1184,0,0,0,0,1,1,4
LJC3980,0,0,1,0,1,2,5
KCD0181,0,0,0,0,1,1,4
ADP3667,0,0,1,0,1,2,5
YJR1149,0,0,0,0,0,0,0
AHC1994,0,0,0,0,1,1,4
AHG3997,0,0,1,0,1,2,5
BJW2134,0,0,0,0,1,1,4
GCN1743,0,0,1,0,1,2,5
SMS2452,1,1,1,1,1,5,13
AHM0959,0,1,1,0,1,3,7
SOD0442,1,0,0,1,1,3,10
EPC3889,0,1,1,1,1,4,9
SRM3245,0,0,0,0,1,1,4
ACH2102,0,0,0,0,1,1,4
JJF1325,0,0,0,0,1,1,4
PWG3063,1,1,1,1,1,5,13
MNM2369,0,1,1,0,1,3,7
MDF1222,0,1,1,1,1,4,9
SKB3752,0,1,1,0,1,3,7
OCD3513,1,1,1,0,0,3,7
LBJ1723,1,1,1,1,1,5,13
JSM3931,0,0,1,0,1,2,5
KPS3882,0,1,1,1,1,4,9
ECM3591,0,0,0,0,1,1,4
MXR3432,0,1,1,1,1,4,9
NEE1632,0,1,1,0,1,3,7
MWG1570,0,0,1,0,1,2,5
CBJ3719,0,1,1,0,1,3,7
HRL2565,1,1,1,0,1,4,11
CTK0947,1,1,1,0,1,4,11
MNW1827,0,0,0,0,1,1,4
PDJ3711,0,1,1,0,1,3,7
INL3041,0,1,1,0,1,3,7
DEP0163,0,1,1,0,1,3,7
ZAW3833,1,1,1,0,1,4,11
MBP1728,0,0,0,0,1,1,4
ISB0256,0,0,0,0,1,1,4
BGM2545,0,0,0,0,1,1,4
LGM2170,0,0,1,0,1,2,5
SXW0537,0,0,0,0,1,1,4
PHH1524,0,0,1,0,1,2,5
GZM3990,0,0,1,0,1,2,5
CMO2396,0,0,0,0,1,1,4
CUQ3097,0,0,0,0,1,1,4
VWB0990,1,1,1,0,1,4,11
JWM0484,0,1,1,1,1,4,9
MEM1745,0,1,1,0,1,3,7
MXG0821,0,0,0,0,1,1,4
MMR1864,0,0,0,0,1,1,4
JKF1825,0,0,0,0,1,1,4
BDM3662,0,0,1,0,1,2,5
LFB1624,1,1,1,0,1,4,11
JSO3292,0,0,1,0,1,2,5
JCC2287,0,1,1,1,1,4,9
AAF3937,0,0,1,0,1,2,5
SST1661,0,1,1,0,1,3,7
ALB2395,0,0,0,0,1,1,4
CNE2161,0,0,1,0,1,2,5
IEG3509,0,1,1,0,1,3,7
VNH1282,0,0,0,0,0,0,0
MJK0037,0,1,1,0,1,3,7
ARC2809,0,0,1,0,1,2,5
SGR0658,0,0,0,0,1,1,4
LCF1216,0,1,1,1,1,4,9
NSE3944,0,0,1,0,1,2,5
INS3200,0,1,1,1,1,4,9
CHC0252,0,0,0,0,1,1,4
LPE0270,0,0,0,0,1,1,4
ABE2352,0,1,1,0,1,3,7
SNM1257,1,1,1,0,1,4,11
RSJ0891,0,0,1,0,1,2,5
FZB3046,0,1,1,0,1,3,7
LMS2868,0,0,1,0,1,2,5
WJM3209,0,0,0,0,1,1,4
JPF1296,0,0,0,0,1,1,4
CNC1177,0,0,0,0,1,1,4
WKF3444,0,1,1,0,1,3,7
DGQ3744,0,1,1,0,1,3,7
SSA0389,0,1,1,0,1,3,7
CWL0561,0,0,0,0,1,1,4
JCP1462,0,0,0,0,1,1,4
KWD2589,0,0,0,0,1,1,4
SVA1742,1,1,0,1,1,4,12
ABP2917,1,1,1,0,1,4,11
GLS1193,0,0,0,0,1,1,4
FPV3755,0,1,1,0,1,3,7
GRP1402,1,1,1,1,1,5,13
FMT2152,0,0,0,0,1,1,4
CMB2034,1,1,1,1,1,5,13
CDY3409,1,1,1,0,1,4,11
VDM2701,0,0,0,0,0,0,0
AFK3800,1,1,1,0,1,4,11
NDB0517,0,1,1,0,1,3,7
JLG3764,0,1,1,0,1,3,7
AKH0454,0,1,1,0,1,3,7
KSF0134,1,0,0,1,1,3,10
GJD1141,0,0,0,0,1,1,4
THH2751,0,0,0,0,1,1,4
AKC1929,0,1,1,1,1,4,9
MGG1756,0,0,1,0,1,2,5
RRM3789,1,1,1,0,1,4,11
MNG3693,0,0,1,0,1,2,5
ASG0072,0,1,1,0,1,3,7
TTL3088,0,0,0,0,1,1,4
KDW2929,0,1,1,0,1,3,7
JJH2332,0,1,1,0,1,3,7
IBM1700,0,1,1,0,1,3,7
OJV2346,0,1,1,0,1,3,7
ZHF1006,0,0,0,0,1,1,4
HLD1270,0,0,0,0,1,1,4
DGH3295,0,0,1,0,1,2,5
KGF2552,0,0,0,0,1,1,4
VTB0576,0,0,0,0,1,1,4
CCS3575,0,0,0,0,1,1,4
SIP2907,0,1,1,0,1,3,7
VBP1871,0,0,0,0,1,1,4
CKG3838,0,0,1,0,1,2,5
MJS1251,0,1,1,0,1,3,7
BWM2339,1,1,1,0,1,4,11
KRH0589,0,0,0,0,1,1,4
WSS0820,0,0,0,0,1,1,4
GFB1385,0,1,1,0,1,3,7
KAC0579,0,0,0,0,1,1,4
MJC1471,0,0,0,0,1,1,4
MBG3183,0,0,0,0,1,1,4
UVN0903,0,0,1,0,1,2,5
UMH3826,1,1,1,1,1,5,13
CJH3136,0,0,0,0,1,1,4
BZC3956,0,0,1,0,0,1,1
AAD3030,0,1,1,0,1,3,7
OCS1541,0,0,1,0,1,2,5
SMW2062,1,1,1,1,1,5,13
LMH2801,0,0,1,0,1,2,5
GGH1726,0,0,0,0,1,1,4
GCK2071,0,1,1,1,1,4,9
RAH2750,0,0,0,0,1,1,4
XAH2479,0,0,0,0,1,1,4
NHG3810,0,1,1,1,1,4,9
HBS0255,0,0,0,0,1,1,4
HOJ2172,0,0,1,0,1,2,5
KNH1985,0,0,0,0,1,1,4
KBG2061,1,1,1,1,1,5,13
HSS3959,0,0,1,0,1,2,5
SCH3567,0,0,0,0,1,1,4
DLR1423,0,0,0,0,1,1,4
JRR0459,0,1,1,0,1,3,7
ZHH3206,0,0,0,0,1,1,4
LRP2591,0,0,0,0,1,1,4
LMF0670,0,0,0,0,1,1,4
JAD3672,0,0,1,0,1,2,5
NSR2539,0,0,0,0,1,1,4
MVA3761,0,1,1,0,1,3,7
JLL1204,1,1,1,0,1,4,11
SCC0067,1,1,1,0,1,4,11
ABK3081,0,0,0,0,1,1,4
SRS0129,1,0,0,1,1,3,10
IMC3296,0,0,1,0,1,2,5
KKB1088,1,1,1,0,1,4,11
YYD3518,1,1,1,0,0,3,7
TCM2403,1,1,1,0,1,4,11
PJP2632,0,0,0,0,1,1,4
BAA2451,1,1,1,1,1,5,13
ROR3483,0,1,1,0,1,3,7
KGD2603,0,0,0,0,1,1,4
RWS3699,0,0,1,0,1,2,5
JDR0436,1,0,0,0,1,2,8
RLS0761,1,1,1,0,1,4,11
GWM1366,0,1,1,0,1,3,7
IJS1090,0,1,1,0,0,2,3
JCG1982,0,0,0,0,1,1,4
DIA0731,1,1,1,0,1,4,11
NMS1493,0,0,1,0,1,2,5
GSA3815,0,1,1,1,1,4,9
GSC0530,0,0,0,0,1,1,4
BDJ3001,0,1,1,1,1,4,9
COB0461,0,1,1,0,0,2,3
HCR3675,0,0,1,0,1,2,5
AIY3991,0,0,1,0,1,2,5
TAC3425,1,1,1,1,1,5,13
RAP0653,0,0,0,0,0,0,0
RPL2640,0,0,0,0,1,1,4
CJH2330,1,1,1,0,1,4,11
JNR1694,0,1,1,0,1,3,7
AMO0582,0,0,0,0,1,1,4
LLT0291,1,0,0,1,1,3,10
CKH0705,0,0,0,0,1,1,4
OMM0835,0,0,0,0,0,0,0
BRD3314,0,0,1,0,1,2,5
CKC3767,0,1,1,0,1,3,7
ILY3152,0,0,0,0,1,1,4
MLP3859,0,1,1,0,1,3,7
DTL2891,1,1,1,0,1,4,11
PGF3491,0,0,1,0,1,2,5
MMR1435,0,0,0,0,1,1,4
ACM3964,0,0,1,0,1,2,5
LLS0222,0,0,1,1,1,3,7
LAH0524,0,0,0,0,1,1,4
EKS3724,0,1,1,0,1,3,7
OED3393,1,1,1,0,1,4,11
JBB0847,0,0,1,0,1,2,5
MRS0409,1,1,1,0,1,4,11
KBW1629,1,1,1,0,1,4,11
SLV2969,0,1,1,0,1,3,7
NWV0966,1,1,1,0,1,4,11
CSM1554,0,0,1,0,1,2,5
KKM0624,0,1,1,0,1,3,7
SJH0945,0,1,1,0,1,3,7
FDF3743,1,1,1,0,1,4,11
SYF1650,1,1,1,0,1,4,11
FLS0231,1,1,1,0,1,4,11
MFD2890,0,1,1,0,1,3,7
JDM0165,0,1,1,1,1,4,9
LOR1044,0,1,1,0,0,2,3
MIA0939,1,1,1,0,1,4,11
BBB3612,0,0,1,0,1,2,5
SHP1418,0,0,0,0,1,1,4
CCL3272,0,0,1,0,1,2,5
SWO3258,0,0,1,0,1,2,5
UNB3986,0,0,1,0,0,1,1
ARB2515,0,0,0,0,1,1,4
GKW2306,0,1,1,1,1,4,9
KWC3812,0,1,1,1,1,4,9
AAP1919,1,1,1,1,1,5,13
TPF1663,1,1,1,0,1,4,11
BEH0103,0,0,0,0,1,1,4
GTC0747,1,1,1,1,1,5,13
AYS1628,0,1,1,0,1,3,7
FBY1064,0,1,1,1,1,4,9
PMA2693,1,1,1,0,1,4,11
GER1997,0,0,0,0,1,1,4
RPC0205,1,0,0,1,1,3,10
LNM1879,0,0,0,0,1,1,4
JAB3656,0,0,1,0,1,2,5
WLL1133,0,0,0,0,1,1,4
AOD2178,0,0,1,0,1,2,5
CBM2858,0,0,1,0,1,2,5
JJH1818,1,1,1,0,1,4,11
HKK2716,0,0,0,0,1,1,4
RIB1582,0,0,1,0,1,2,5
JAS1907,1,1,1,1,1,5,13
WSA1765,0,1,1,0,1,3,7
NNP0229,1,1,1,0,1,4,11
XAR1011,1,1,1,1,1,5,13
RLB1334,0,0,0,0,1,1,4
HJD3439,1,1,1,1,1,5,13
WAH3836,0,0,1,0,1,2,5
VAD2639,0,0,0,0,1,1,4
GIB0207,1,0,1,1,1,4,11
DJR2389,0,0,0,0,1,1,4
PEB3161,0,0,0,0,1,1,4
BHS1917,1,1,1,1,1,5,13
DKS1509,0,0,1,0,1,2,5
KMS1530,0,0,1,0,1,2,5
SHS3176,0,0,0,0,1,1,4
SGM2153,0,0,1,0,0,1,1
GNG2812,0,0,1,0,1,2,5
BRS0333,0,0,1,0,1,2,5
DAS3775,1,1,1,0,1,4,11
TMC3659,0,0,1,0,1,2,5
YKM3542,1,1,1,0,1,4,11
PMG2513,0,0,0,0,1,1,4
ATR1677,0,1,1,0,1,3,7
MJB3866,1,1,1,1,1,5,13
VJM1336,0,0,0,0,1,1,4
AHC3277,0,0,1,0,1,2,5
RCV1311,0,0,0,0,1,1,4
VKM2376,1,1,1,0,1,4,11
JMG3704,0,0,1,0,1,2,5
SCF0330,1,0,0,1,1,3,10
NNB3989,0,0,1,0,1,2,5
BCS2912,0,1,1,0,1,3,7
RDF1248,0,1,1,0,1,3,7
ARH2262,1,1,1,0,1,4,11
KNM1318,0,0,0,0,1,1,4
HDP1890,0,0,0,0,1,1,4
KSS2068,1,1,1,1,1,5,13
RGM3111,0,0,0,0,1,1,4
FAW1969,0,0,0,0,1,1,4
DAR0388,0,1,1,0,1,3,7
MCT1067,0,1,1,1,1,4,9
ASS0280,0,0,0,0,1,1,4
NOD1261,0,1,1,0,0,2,3
ENS1748,0,1,1,0,1,3,7
EPI3052,0,1,1,0,1,3,7
AGS0063,1,1,1,1,1,5,13
RCS2064,1,1,1,1,1,5,13
SED0972,0,1,1,1,1,4,9
AID2774,0,0,1,0,1,2,5
APS1968,0,0,0,0,1,1,4
DBR1798,0,1,1,0,1,3,7
BWK0172,0,0,0,0,1,1,4
CSB0827,0,0,0,0,1,1,4
ASH1710,0,0,0,0,1,1,4
KOB2624,0,0,0,0,1,1,4
DEL0913,1,1,1,0,1,4,11
OKG1889,0,0,0,0,1,1,4
WZR3948,0,0,1,0,1,2,5
IHD1978,0,0,0,0,1,1,4
MMC1084,1,1,1,0,1,4,11
BLY1039,0,0,1,0,1,2,5
YCL2166,0,0,1,0,1,2,5
NHV2004,0,0,0,0,0,0,0
BNL1652,1,1,1,0,1,4,11
VHH0485,1,1,1,1,1,5,13
LXS0332,0,0,1,0,1,2,5
GLG1573,0,0,1,0,0,1,1
RCG1241,1,1,1,0,1,4,11
MJP2421,0,0,1,0,1,2,5
DNN0488,1,1,1,0,1,4,11
WVD0570,0,0,0,0,1,1,4
EJP2315,1,1,1,0,1,4,11
HKW2615,0,0,0,0,1,1,4
SGB1636,0,1,1,0,1,3,7
SZB0321,0,0,1,0,1,2,5
YLL0795,0,0,0,0,1,1,4
JKC2754,0,0,0,0,1,1,4
MNS1394,0,1,1,1,1,4,9
TWM0837,0,0,1,0,1,2,5
RSS0875,0,0,1,0,1,2,5
XAB0627,1,1,1,0,1,4,11
DNV1964,0,0,0,0,1,1,4
MAC2962,0,1,1,1,1,4,9
WIB3670,0,0,1,0,1,2,5
JBB3280,0,0,1,0,1,2,5
PHB2209,0,0,1,0,1,2,5
WOL3226,0,0,0,0,1,1,4
RUB1156,0,0,0,0,1,1,4
SRB2276,0,1,1,0,1,3,7
AIB3416,0,1,1,1,1,4,9
DAE1437,0,0,0,0,1,1,4
SCH3858,0,1,1,0,1,3,7
FKS0094,0,0,0,0,1,1,4
CIH0995,0,0,0,0,1,1,4
LAN1329,0,0,0,0,0,0,0
NCB2660,0,0,0,0,1,1,4
YDM3898,1,1,1,1,1,5,13
LMW2320,0,1,1,0,1,3,7
NPK0369,0,0,1,0,1,2,5
DMB1429,0,0,0,0,1,1,4
KMB1761,0,1,1,0,1,3,7
TWK1773,1,1,1,0,1,4,11
ATR2560,1,1,1,0,1,4,11
HNB3661,0,0,1,0,1,2,5
GJG0170,0,0,0,0,1,1,4
ABG2353,1,1,1,0,1,4,11
BAT3066,1,1,1,1,1,5,13
NKM2195,0,0,1,0,1,2,5
KTL3785,1,1,1,0,1,4,11
WJR3544,1,1,1,0,1,4,11
AJM0243,0,1,1,0,1,3,7
TND0324,1,0,0,1,1,3,10
LDB3087,0,0,0,0,1,1,4
WMR2625,0,0,0,0,1,1,4
BRH2866,0,0,1,0,0,1,1
AVS2317,0,1,1,0,1,3,7
NWH2076,0,0,0,0,1,1,4
ISG2025,0,0,0,0,1,1,4
SRB2600,0,0,0,0,1,1,4
CRH3848,0,0,1,0,1,2,5
VRB3401,0,1,1,0,1,3,7
CWH3033,1,1,1,0,1,4,11
JDM1042,0,1,1,0,1,3,7
GLM3106,0,0,0,0,1,1,4
MGS2159,0,0,1,0,1,2,5
KAW3589,0,1,1,0,1,3,7
TLP1231,1,1,1,1,1,5,13
GCP2425,1,1,1,0,1,4,11
TDM2859,0,0,1,0,1,2,5
ARS3506,1,1,1,0,1,4,11
TTP2417,0,0,1,0,1,2,5
CLH0733,1,1,1,0,1,4,11
JMS0149,0,1,1,1,1,4,9
NSC3036,0,1,1,0,1,3,7
ATH0225,1,1,1,1,1,5,13
RPW0026,1,0,0,1,0,2,6
SWG1391,0,1,1,1,1,4,9
KMR2232,0,0,1,0,1,2,5
XSR3526,0,0,0,0,1,1,4
BDJ3326,0,0,1,0,1,2,5
TWF1072,1,1,1,1,1,5,13
QKO2718,0,0,0,0,1,1,4
LDW1472,0,0,0,0,0,0,0
TCN1687,1,1,1,0,1,4,11
DTU3804,0,1,1,1,1,4,9
AFP2247,0,0,1,0,1,2,5
ALS2669,1,1,1,0,1,4,11
KJC1419,0,0,0,0,1,1,4
SDR1227,1,1,1,1,1,5,13
ZMH1543,0,0,1,0,1,2,5
JSH1070,1,1,1,1,0,4,9
AFH1757,0,1,1,0,1,3,7
DMD0486,0,1,1,1,1,4,9
OHG3736,0,1,1,0,1,3,7
GCT3750,0,1,1,0,1,3,7
DFW1467,0,0,0,0,1,1,4
NOE2965,0,1,1,0,1,3,7
SCE1877,0,0,0,0,1,1,4
IGP2254,1,1,1,0,1,4,11
IAR3996,0,0,1,0,1,2,5
MTN1330,0,0,0,0,1,1,4
GEK3441,0,1,1,0,1,3,7
SBK3515,0,1,1,0,1,3,7
XKW1135,0,0,0,0,1,1,4
SKA0757,0,1,1,0,1,3,7
JEV3132,1,1,1,0,1,4,11
SER0621,0,1,1,0,1,3,7
LSL0337,0,0,1,0,1,2,5
JYM3047,0,1,1,0,1,3,7
ASD0993,0,1,1,0,1,3,7
SAP1888,0,0,0,0,1,1,4
XCJ0023,1,0,0,1,1,3,10
OJR2085,0,0,0,0,1,1,4
LEM1913,1,1,1,1,1,5,13
LJC0191,0,0,0,0,0,0,0
JBS1291,0,0,0,0,1,1,4
JHK1849,0,0,0,0,0,0,0
DPF3215,0,0,0,0,1,1,4
CWA2554,1,1,1,0,1,4,11
NIR3139,0,0,0,0,1,1,4
JAM2248,0,0,1,0,1,2,5
MSR2202,0,0,1,0,1,2,5
GOR0861,0,0,1,0,1,2,5
PWM0708,0,0,0,0,1,1,4
AAD2188,0,0,1,0,1,2,5
SSR1962,0,0,0,0,1,1,4
PMT2264,0,1,1,0,1,3,7
DHK0367,1,0,0,1,1,3,10
MAL0434,1,0,0,1,1,3,10
LMB3241,0,0,0,0,1,1,4
DGE3194,0,1,1,1,0,3,5
BNS2384,0,1,1,1,1,4,9
CIS3505,0,0,1,0,1,2,5
UAS2829,0,0,1,0,1,2,5
CSC3074,0,0,0,0,1,1,4
KCM0806,0,0,0,0,1,1,4
TDH0989,0,1,1,1,1,4,9
CSL0428,0,1,1,1,1,4,9
LBG1670,1,1,1,0,1,4,11
DCW2405,1,1,0,1,1,4,12
LDN2514,0,0,0,0,1,1,4
ZIR1732,0,0,1,0,1,2,5
MEB3004,0,0,0,0,1,1,4
NEH1185,0,0,0,0,0,0,0
PHO1937,1,1,1,0,1,4,11
OAP2825,0,0,1,0,1,2,5
DKF2721,0,0,0,0,1,1,4
ZGP2957,1,1,1,1,1,5,13
CAP2283,0,1,1,1,1,4,9
DJC0073,0,1,1,0,1,3,7
ANB0938,0,1,1,0,1,3,7
SOB0089,0,1,1,0,1,3,7
JBW0109,0,0,0,0,1,1,4
DAM2837,0,0,1,0,1,2,5
SSL2271,1,1,1,0,1,4,11
DJF2329,1,1,1,0,1,4,11
BJF0511,1,1,1,0,0,3,7
LTH1795,0,1,1,0,1,3,7
ADH0975,0,1,1,1,1,4,9
CJJ1491,0,0,1,0,1,2,5
AEB1458,0,0,0,0,1,1,4
KPO3619,0,0,1,0,1,2,5
KJB0354,1,0,0,1,1,3,10
CMA2616,0,0,0,0,1,1,4
DNM2823,0,0,1,0,1,2,5
HWC3907,1,1,1,1,0,4,9
KTW3547,1,1,1,0,1,4,11
ARM0076,0,1,1,1,1,4,9
KTS3908,0,0,1,0,0,1,1
GAC2529,0,0,0,0,1,1,4
AWM2286,0,1,1,1,1,4,9
KCR0577,0,0,0,0,1,1,4
PFC3807,1,1,1,1,1,5,13
RAA3570,0,0,0,0,1,1,4
MRH2516,0,0,0,0,1,1,4
SRA3210,0,0,0,0,1,1,4
PEV3531,0,0,0,0,1,1,4
TDJ3138,0,0,0,0,1,1,4
FGS3275,0,0,1,0,1,2,5
AJH0279,0,0,0,0,1,1,4
EAP1555,0,0,1,0,1,2,5
EDV1427,0,0,0,0,1,1,4
SAM3782,0,1,1,0,1,3,7
MRS0368,1,0,0,1,1,3,10
DBG3727,0,1,1,0,1,3,7
EDP1880,0,0,0,0,1,1,4
LCT2783,0,0,1,0,0,1,1
CAR2748,0,0,0,0,1,1,4
DLC2903,0,1,1,0,1,3,7
KKC2119,0,0,0,0,1,1,4
IDW1211,1,1,1,0,1,4,11
SCM3407,0,1,1,0,1,3,7
DJS1271,0,0,0,0,1,1,4
DRF3992,0,0,1,0,1,2,5
ICB3167,0,0,0,0,0,0,0
QBL1386,1,1,1,0,1,4,11
CLM1874,0,0,0,0,1,1,4
ZBH3422,1,1,1,1,1,5,13
SMC2898,1,1,1,0,1,4,11
CSB3932,0,0,1,0,1,2,5
TAF0640,0,1,1,1,1,4,9
PRH1717,0,1,1,1,1,4,9
ABB0167,1,1,1,1,0,4,9
FCE0695,0,0,0,0,1,1,4
TPG2392,0,0,0,0,1,1,4
VDP0790,0,0,0,0,1,1,4
JPH1129,0,0,0,0,1,1,4
DAM3359,0,1,1,0,1,3,7
BJA1137,0,0,0,0,1,1,4
RKH2877,1,1,1,0,1,4,11
CAS3022,0,1,1,0,1,3,7
RDP2116,0,0,0,0,1,1,4
NCT0983,0,1,1,1,1,4,9
AKC3739,0,1,1,0,1,3,7
PDK3856,0,1,1,0,1,3,7
AME1361,0,1,1,0,1,3,7
BZS1344,1,1,1,1,1,5,13
MBS3902,1,1,1,1,1,5,13
ADV1640,1,1,1,0,0,3,7
GKL0006,1,0,0,1,1,3,10
BRG3113,0,0,0,0,1,1,4
CAG0502,1,1,1,0,1,4,11
DBC1073,0,1,1,1,1,4,9
XPW2833,0,0,1,0,1,2,5
JMB2246,0,0,1,0,1,2,5
RSG0687,0,0,0,0,1,1,4
IJC2459,0,1,1,0,1,3,7
BEW1426,0,0,0,0,1,1,4
FNB1512,0,0,1,0,0,1,1
IAC3581,1,1,1,0,1,4,11
ABL0870,0,0,1,0,1,2,5
MLB1214,1,1,1,0,0,3,7
LAE1350,1,1,1,1,1,5,13
FQL3629,0,0,1,0,1,2,5
CDW0886,0,0,1,0,0,1,1
GIS1668,1,1,1,0,1,4,11
MHA0667,0,0,0,0,1,1,4
RML2759,0,0,0,0,1,1,4
RBO0327,1,0,0,1,1,3,10
JCB2350,0,1,1,0,1,3,7
AUG2242,0,0,1,0,1,2,5
BMN3207,0,0,0,0,1,1,4
XGB1528,0,0,1,0,1,2,5
KRL0467,1,1,1,0,1,4,11
BJR0940,0,1,1,0,1,3,7
BAC3730,1,1,1,0,1,4,11
BHC2344,0,1,1,0,1,3,7
ODW2194,0,0,1,0,0,1,1
EID1076,1,1,1,1,0,4,9
CGM3124,1,1,1,0,0,3,7
EKM0863,0,0,1,0,1,2,5
LQC3780,0,1,1,0,1,3,7
KKM0309,0,0,1,0,1,2,5
BKB0853,0,0,1,0,1,2,5
BHC0492,0,1,1,0,1,3,7
LVK3180,0,0,0,0,0,0,0
BZH1158,0,0,0,0,1,1,4
HBC3497,0,1,1,0,1,3,7
CMM3753,0,1,1,0,1,3,7
GMC1209,1,1,1,0,0,3,7
MCN0985,0,1,1,1,1,4,9
JBH2559,1,1,1,0,1,4,11
PAB0879,0,0,1,0,1,2,5
ORH2010,0,0,0,0,1,1,4
IKG3154,0,0,0,0,1,1,4
MBH0476,0,1,1,1,1,4,9
JAC2001,0,0,0,0,1,1,4
BKF1545,0,0,1,0,1,2,5
JHC1809,0,1,1,0,1,3,7
JFB0961,1,1,1,0,1,4,11
MMJ3368,1,1,1,0,1,4,11
SWM0188,0,0,0,0,1,1,4
NRE1755,0,0,1,0,1,2,5
RCB2645,0,0,0,0,1,1,4
ANL3024,0,1,1,0,1,3,7
RCJ0557,0,0,0,0,1,1,4
JFB2168,0,0,1,0,1,2,5
RMC2177,0,0,1,0,1,2,5
CTW2038,1,1,1,1,0,4,9
SDH1556,0,0,1,0,1,2,5
RDE3239,0,0,0,0,1,1,4
GBJ3604,0,0,0,0,1,1,4
HHS3357,0,1,1,0,1,3,7
SDH2394,0,0,0,0,1,1,4
KMS0568,0,0,0,0,0,0,0
BOH1751,0,1,1,0,1,3,7
AAV3669,0,0,1,0,1,2,5
HSA2065,1,1,1,1,1,5,13
CSB2910,0,1,1,0,1,3,7
CDL0867,0,0,1,0,1,2,5
JTV2654,0,0,0,0,1,1,4
KJH0588,0,0,0,0,1,1,4
KOW3756,0,1,1,0,1,3,7
RCM3458,0,1,1,0,1,3,7
BJH3402,0,1,1,0,1,3,7
LCW3879,1,1,1,1,1,5,13
SJT0698,0,0,0,0,1,1,4
UAD2700,0,0,0,0,0,0,0
FGK1026,1,1,0,0,1,3,10
CTC0421,0,1,1,1,1,4,9
TSO3216,0,0,0,0,1,1,4
MVW3821,0,1,1,1,1,4,9
RND1473,0,0,0,0,1,1,4
JKH3673,0,0,1,0,1,2,5
CAF3929,0,0,1,0,1,2,5
SAB2761,0,0,0,0,1,1,4
DAS1955,0,0,0,0,0,0,0
JJY3112,0,0,0,0,1,1,4
RSS3182,0,0,0,0,0,0,0
SAP2173,0,0,1,0,1,2,5
MGM0569,0,0,0,0,1,1,4
BBM1701,0,1,1,0,1,3,7
HIA2415,0,0,1,0,1,2,5
AAF0819,0,0,0,0,1,1,4
KEW1179,0,0,0,0,1,1,4
CJM2961,1,1,1,1,1,5,13
JMH1847,0,0,0,0,1,1,4
STC2042,1,1,1,1,1,5,13
SPM1684,0,1,1,0,1,3,7
TBD2008,0,0,0,0,1,1,4
NHS3981,0,0,1,0,1,2,5
FAJ0523,0,0,0,0,1,1,4
JPS2432,0,1,1,0,1,3,7
NUK1513,0,0,1,0,1,2,5
KNH0316,1,0,0,1,1,3,10
AAS2987,0,1,1,0,1,3,7
LCP0572,0,0,0,0,1,1,4
CBW2427,0,1,1,0,1,3,7
ZSW2155,0,0,1,0,1,2,5
DTC2566,1,1,1,0,1,4,11
MAB1775,0,1,1,0,1,3,7
WPR1884,0,0,0,0,1,1,4
AKK2125,0,0,0,0,1,1,4
BHK2196,0,0,1,0,1,2,5
SLC1588,0,1,1,0,1,3,7
BBA1230,0,1,1,1,1,4,9
KBP2753,0,0,0,0,1,1,4
GLM3450,0,1,1,0,1,3,7
BNH2692,1,1,1,0,1,4,11
MHS1125,0,0,0,0,1,1,4
QSB1577,0,0,1,0,1,2,5
ARZ3464,1,1,1,0,1,4,11
OXS0363,1,0,0,1,1,3,10
IAA3012,0,0,1,0,1,2,5
CWC0490,1,1,1,0,1,4,11
DWK2099,0,0,0,0,1,1,4
NCS0425,0,1,1,1,1,4,9
KAP0844,0,0,1,0,1,2,5
WHH2938,0,1,1,1,1,4,9
BAB1619,0,1,1,0,1,3,7
LAV1050,0,1,1,0,0,2,3
RAS3446,0,1,1,0,1,3,7
VYP0637,0,1,1,1,0,3,5
AIJ0383,1,1,1,0,1,4,11
MDO0606,1,1,1,0,1,4,11
MSS3335,0,0,1,0,1,2,5
RVV0317,1,0,0,1,1,3,10
ICL0565,0,0,0,0,1,1,4
SGW0112,0,0,0,0,1,1,4
HCR1322,0,0,0,0,1,1,4
HGH0727,0,1,1,0,1,3,7
NRT1320,0,0,0,0,1,1,4
TKM2494,0,0,0,0,1,1,4
MLC3482,0,0,1,0,1,2,5
SNM1696,1,1,1,0,1,4,11
MTW3317,0,0,1,0,1,2,5
CAG3622,0,0,1,0,1,2,5
AIV3936,0,0,1,0,1,2,5
SCB2814,0,0,1,0,1,2,5
JIR2594,0,0,0,0,1,1,4
CSS1313,0,0,0,0,1,1,4
DBH1596,0,1,1,0,1,3,7
KBM3734,0,1,1,0,1,3,7
MET1881,0,0,0,0,1,1,4
QIS2940,0,1,1,1,1,4,9
CAB3121,0,1,1,0,1,3,7
HRK2972,1,1,1,0,1,4,11
MCW2546,0,0,0,0,1,1,4
MHB0845,0,0,1,0,1,2,5
EGD3972,0,0,1,0,0,1,1
CMW0437,1,0,0,0,1,2,8
PCC0604,0,1,1,0,1,3,7
FCM3792,1,1,1,0,1,4,11
TMV0868,0,0,1,0,1,2,5
BGH2861,0,0,1,0,1,2,5
AHH0495,1,1,1,0,1,4,11
CCN2726,0,0,0,0,1,1,4
ZAW2012,0,0,0,0,1,1,4
MZG2261,0,1,1,0,1,3,7
AVT0526,0,0,0,0,0,0,0
LNP3092,0,0,0,0,1,1,4
LMM3366,0,1,1,0,1,3,7
DJP3230,0,0,0,0,1,1,4
OAG1468,0,0,0,0,0,0,0
KNW1321,0,0,0,0,1,1,4
NBL2243,0,0,1,0,1,2,5
STN2458,0,1,1,1,0,3,5
SBS1606,0,1,1,0,1,3,7
AAM0729,0,1,1,0,1,3,7
HSF1454,0,0,0,0,1,1,4
GAH0525,0,0,0,0,1,1,4
CRL3842,1,0,1,0,1,3,9
DKP0671,0,0,0,0,1,1,4
NSC1741,1,1,0,1,1,4,12
BAG2641,0,0,0,0,1,1,4
CSW3811,0,1,1,1,0,3,5
JJH0681,0,0,0,0,1,1,4
APS3701,0,0,1,0,1,2,5
BRC3949,0,0,1,0,1,2,5
CLR2407,1,1,0,1,1,4,12
LRS2996,0,1,1,1,1,4,9
NVL2180,0,0,1,0,1,2,5
SEM2492,0,0,0,0,1,1,4
JFG1049,0,1,1,0,1,3,7
RJD2647,0,0,0,0,1,1,4
ETA0791,0,0,0,0,1,1,4
BSM2844,0,0,1,0,1,2,5
ANB2766,0,0,0,0,1,1,4
JMR3367,0,1,1,0,1,3,7
LRL1316,0,0,0,0,1,1,4
SLS2992,0,1,1,0,1,3,7
DKM2980,0,1,1,0,1,3,7
PLM3935,0,0,1,0,1,2,5
PPT3162,0,0,0,0,1,1,4
IBV1578,0,0,1,0,0,1,1
BMV1886,0,0,0,0,1,1,4
CLM2776,0,0,1,0,1,2,5
LZM0306,0,0,1,0,1,2,5
RHR2835,0,0,1,0,1,2,5
WRW2331,1,1,1,0,1,4,11
TFH0544,0,0,0,0,1,1,4
ACS0128,1,0,0,1,0,2,6
VGM2096,0,0,0,0,1,1,4
IMM2118,0,0,0,0,1,1,4
WTF0449,0,1,1,0,1,3,7
OLR2564,1,1,1,0,1,4,11
VJK1327,0,0,0,0,1,1,4
MLJ1461,0,0,0,0,1,1,4
CKH2797,0,0,1,0,1,2,5
GRG3005,1,1,1,1,1,5,13
APD0381,0,1,1,0,1,3,7
GAW0808,0,0,0,0,1,1,4
JME0387,0,1,1,0,1,3,7
BUS2399,0,0,1,0,1,2,5
YRA3503,0,1,1,0,1,3,7
WMR2685,1,1,1,0,1,4,11
ADP1625,0,1,1,0,1,3,7
AMM0734,0,1,1,1,1,4,9
VKM2949,0,1,1,1,1,4,9
SKS0339,0,0,1,0,1,2,5
CDM0538,0,0,0,0,1,1,4
NGR2884,0,1,1,0,1,3,7
BCB2676,1,1,1,1,1,5,13
ARG3554,1,1,1,0,1,4,11
AFP2709,0,0,0,0,1,1,4
HCO3108,0,0,0,0,1,1,4
HMM2768,0,0,0,0,1,1,4
SCH3716,0,1,1,0,1,3,7
CVB2703,0,0,0,0,1,1,4
AWW0254,0,0,0,0,0,0,0
RAB1712,0,0,0,0,1,1,4
SWG2200,0,0,1,0,1,2,5
KJR1377,1,1,1,0,1,4,11
JGR3914,0,0,1,0,1,2,5
CKG1972,0,0,0,0,1,1,4
MLM2021,0,0,0,0,0,0,0
KAH3247,0,0,0,0,1,1,4
EIR1046,0,1,1,0,1,3,7
BDU0497,1,1,1,0,1,4,11
CAR2244,0,0,1,0,1,2,5
GGM3737,1,1,1,0,1,4,11
QBR2250,0,0,1,0,1,2,5
TBM0932,0,1,1,0,1,3,7
NGH1256,0,1,1,0,1,3,7
HAM2252,0,0,1,0,1,2,5
BBP1093,0,1,1,0,1,3,7
JDS0516,1,1,1,0,0,3,7
COK3383,0,1,1,0,1,3,7
AME0732,0,1,1,0,1,3,7
FNR0635,0,1,1,1,1,4,9
TKK0628,0,1,1,0,1,3,7
RCW3692,0,0,1,0,1,2,5
RDB0702,0,0,0,0,1,1,4
SAC3963,0,0,1,0,1,2,5
MJW2032,1,1,1,1,0,4,9
MPY0478,0,1,1,1,1,4,9
CDM1097,1,1,1,0,0,3,7
ARW0818,0,0,0,0,1,1,4
RJB2622,0,0,0,0,1,1,4
PLJ3274,0,0,1,0,1,2,5
BKR3146,0,0,0,0,1,1,4
KBK3593,0,0,0,0,1,1,4
CNB1131,0,0,0,0,1,1,4
EHW2450,1,1,1,1,1,5,13
SAR1883,0,0,0,0,1,1,4
NHD2497,0,0,0,0,1,1,4
WBE0967,0,1,1,1,1,4,9
MFB0040,0,1,1,0,1,3,7
SDM2550,0,0,0,0,1,1,4
JUM0102,0,0,0,0,1,1,4
CMT0267,0,0,0,0,1,1,4
RKH1801,1,1,1,0,1,4,11
CCB0547,0,0,0,0,1,1,4
BJP0186,0,0,0,0,1,1,4
VKT2228,0,0,1,0,1,2,5
HQB3494,0,0,1,0,1,2,5
KCR2291,1,1,1,1,1,5,13
AKD0272,0,0,0,0,1,1,4
TKE3293,0,0,1,0,1,2,5
EDF2361,0,1,1,0,1,3,7
RAC0362,1,0,0,1,1,3,10
KCH3095,0,0,0,0,1,1,4
RFS2923,0,1,1,0,1,3,7
EIF1865,0,0,0,0,1,1,4
ESS3341,0,0,1,0,1,2,5
QAH1315,0,0,0,0,1,1,4
SOK1299,0,0,0,0,0,0,0
ENH3969,0,0,1,0,0,1,1
MLV3376,0,1,1,0,1,3,7
DTW3549,1,1,1,0,1,4,11
KQW0164,0,1,1,1,1,4,9
LLJ1243,0,1,1,0,1,3,7
ACN2347,0,1,1,0,1,3,7
JIN3522,0,0,0,0,1,1,4
JHF1278,0,0,0,0,1,1,4
CPR1800,1,1,1,0,1,4,11
KLZ0507,0,1,1,0,1,3,7
JWW2765,0,0,0,0,1,1,4
WOV3040,0,1,1,0,0,2,3
ADM1894,0,0,0,0,1,1,4
EAM3642,0,0,1,0,1,2,5
KGB0500,1,1,1,0,1,4,11
NAH3759,0,1,1,0,1,3,7
YOH1176,0,0,0,0,0,0,0
NSM2805,0,0,1,0,1,2,5
ACF1806,0,1,1,0,0,2,3
DBV2736,0,0,0,0,1,1,4
IEG2687,0,1,1,0,1,3,7
SKE3262,0,0,1,0,1,2,5
TAB1870,0,0,0,0,1,1,4
DNB2574,1,1,1,1,1,5,13
RRH3057,1,1,1,1,1,5,13
WNW2002,0,0,0,0,1,1,4
HBC1540,0,0,1,0,1,2,5
DRF1498,0,0,1,0,1,2,5
SAH2292,0,1,1,1,1,4,9
FKA0393,0,1,1,0,1,3,7
CJH2921,0,1,1,0,1,3,7
SBM2719,0,0,0,0,1,1,4
MWK3854,0,1,1,0,1,3,7
CMH2342,0,1,1,0,1,3,7
QFP3467,0,1,1,0,1,3,7
CQC0997,0,0,0,0,1,1,4
AJH3517,1,1,1,0,1,4,11
BGA0892,0,0,1,0,1,2,5
HGJ2592,0,0,0,0,1,1,4
GYH3476,0,0,0,0,1,1,4
DHC1989,0,0,0,0,1,1,4
RHB1721,0,0,0,0,1,1,4
OGW0251,0,0,0,0,1,1,4
ABH0349,0,0,1,0,1,2,5
BBH2509,0,0,0,0,1,1,4
KSO2224,0,0,1,0,1,2,5
CDM2075,0,0,0,0,1,1,4
SQC2334,0,1,1,0,1,3,7
JSB0783,0,0,0,0,1,1,4
HJR3540,0,0,0,0,1,1,4
ABP2003,0,0,0,0,1,1,4
LYS3814,0,1,1,1,1,4,9
MBA1797,0,1,1,0,0,2,3
BQK2024,0,0,0,0,1,1,4
MMM2156,0,0,1,0,1,2,5
TQR3104,0,0,0,0,1,1,4
XUC1092,0,1,1,0,1,3,7
FDV1224,1,1,1,1,1,5,13
FDM1933,1,1,1,0,1,4,11
CBL3631,0,0,1,0,1,2,5
LFF1887,0,0,0,0,1,1,4
ATT0293,1,0,0,1,1,3,10
EFJ1685,0,1,1,0,1,3,7
AOM1457,0,0,0,0,1,1,4
GDH2500,0,0,0,0,1,1,4
JSR3988,0,0,1,0,1,2,5
IOP1859,0,0,0,0,1,1,4
NJS2498,0,0,0,0,1,1,4
CSV3305,0,0,1,0,1,2,5
EMR3880,1,1,1,1,1,5,13
ZAF3065,1,1,1,1,1,5,13
MFW0646,0,0,0,0,1,1,4
GYM1926,1,1,1,0,1,4,11
DFC3287,0,0,1,0,1,2,5
CAP1971,0,0,0,0,1,1,4
HBH2368,0,1,1,0,1,3,7
VIB2070,0,1,1,1,1,4,9
NHE3204,0,0,0,0,0,0,0
BKM3611,0,0,1,0,1,2,5
DAM2705,0,0,0,0,1,1,4
KNM0423,1,1,1,1,0,4,9
MDH3639,0,0,1,0,1,2,5
BRN3289,0,0,1,0,1,2,5
BGA2301,0,1,1,1,1,4,9
SAB0817,0,0,0,0,1,1,4
SJY3732,0,1,1,0,1,3,7
TFB1229,0,1,1,1,1,4,9
MFK0902,0,0,1,0,1,2,5
MSH1269,0,0,0,0,1,1,4
AMA2808,0,0,1,0,1,2,5
PMG1376,0,1,1,0,1,3,7
TNV3213,0,0,0,0,1,1,4
PTO1063,0,1,1,0,1,3,7
DOM0586,0,0,0,0,0,0,0
KLP3864,0,1,1,1,1,4,9
JHK3122,1,1,1,0,1,4,11
BAV0390,0,1,1,0,0,2,3
DFH1681,0,1,1,0,1,3,7
LLG2714,0,0,0,0,1,1,4
TIJ1817,1,1,1,0,1,4,11
CAF1331,0,0,0,0,1,1,4
VFM3223,0,0,0,0,1,1,4
NQO2712,0,0,0,0,1,1,4
LBB0453,0,1,1,0,1,3,7
FXD3105,0,0,0,0,1,1,4
AKB3530,0,0,0,0,0,0,0
CYO1575,0,0,1,0,1,2,5
EVO1522,0,0,1,0,1,2,5
FKJ1521,0,0,1,0,1,2,5
HDC2132,0,0,0,0,1,1,4
ANK0777,0,0,0,0,1,1,4
BAW0780,0,0,0,0,1,1,4
VKE0655,0,0,0,0,1,1,4
CMS2897,1,1,1,0,1,4,11
ICH2378,0,0,0,0,1,1,4
CIT0310,0,0,1,0,1,2,5
JHM0583,0,0,0,0,1,1,4
AMH3562,0,0,0,0,1,1,4
CUP2764,0,0,0,0,1,1,4
SAB3286,0,0,1,0,1,2,5
CJT1106,0,1,1,0,1,3,7
JBM3933,0,0,1,0,1,2,5
FVR0881,0,0,1,0,1,2,5
VEW0278,0,0,0,0,0,0,0
KAH2460,0,1,1,0,1,3,7
AJP1199,0,0,0,0,1,1,4
HCB1643,0,1,1,0,1,3,7
BKW1032,1,0,1,0,1,3,9
OSC1925,1,1,1,1,1,5,13
DOT1898,0,0,0,0,0,0,0
NCM3725,1,1,1,0,1,4,11
NDA0536,0,0,0,0,1,1,4
GDG2354,0,1,1,0,1,3,7
AGE1244,0,1,1,0,1,3,7
GDM3835,1,1,1,1,1,5,13
FAL1867,0,0,0,0,1,1,4
HDG2848,0,0,1,0,1,2,5
HEW2164,0,0,1,0,1,2,5
KMR0682,0,0,0,0,1,1,4
ECA1221,1,1,1,1,1,5,13
ARC1725,1,1,1,1,1,5,13
DRK3644,0,0,1,0,0,1,1
TAB0684,0,0,0,0,1,1,4
NJG2979,1,1,1,0,1,4,11
CMP2946,1,1,1,1,0,4,9
CKP0659,0,0,0,0,0,0,0
HCM2945,1,1,1,1,1,5,13
JDB3127,1,1,1,0,1,4,11
JCR1148,0,0,0,0,1,1,4
KAS2029,1,1,1,1,1,5,13
DAR3637,0,0,1,0,1,2,5
MDG0657,0,0,0,0,1,1,4
ATR3231,0,0,0,0,1,1,4
CTH2220,0,0,1,0,1,2,5
APA1788,0,1,1,1,1,4,9
TJB0540,0,0,0,0,1,1,4
ARC3034,0,1,1,0,1,3,7
ACW0464,1,1,1,0,1,4,11
RAF1290,0,0,0,0,1,1,4
HSP1675,0,1,1,0,1,3,7
PJC1252,0,1,1,0,1,3,7
ARC1223,0,1,1,1,1,4,9
MCS3301,0,0,1,0,1,2,5
AGF2302,0,1,1,1,0,3,5
OJT3599,0,0,0,0,0,0,0
BWG3220,0,0,0,0,1,1,4
AAC0610,1,1,1,0,1,4,11
ISH0051,1,0,0,1,1,3,10
SLB2519,0,0,0,0,1,1,4
FJA1848,0,0,0,0,1,1,4
THR3371,0,1,1,0,1,3,7
SLL0504,0,1,1,0,1,3,7
JPJ0227,0,1,1,1,1,4,9
KEH0665,0,0,0,0,1,1,4
LDB3304,0,0,1,0,1,2,5
ZWS3625,0,0,1,0,1,2,5
LAS3757,0,1,1,0,1,3,7
JDH1027,1,1,0,0,1,3,10
CBD0802,0,0,0,0,1,1,4
BBM3688,0,0,1,0,1,2,5
HNB2571,1,1,1,1,1,5,13
IPK2575,0,1,1,1,1,4,9
JKD1115,0,1,1,0,1,3,7
RKG2587,0,0,0,0,1,1,4
AVH3584,1,1,1,0,1,4,11
AJK0611,1,1,1,0,1,4,11
PXR3453,1,1,1,0,1,4,11
BNR2527,0,0,0,0,1,1,4
LMJ1783,0,1,1,1,1,4,9
TAP0631,1,1,1,0,1,4,11
CCW3901,1,1,1,1,1,5,13
RWN1705,0,0,1,1,1,3,7
ALN2046,0,1,1,1,1,4,9
AZK0622,0,1,1,0,1,3,7
ASK0599,1,1,1,1,1,5,13
WBL2852,0,0,1,0,1,2,5
OCC0107,0,0,0,0,1,1,4
GSS0841,0,0,1,0,1,2,5
BRB2143,0,0,0,0,1,1,4
JJA1399,0,1,1,1,1,4,9
BAB2968,0,1,1,0,1,3,7
OMP1671,1,1,1,0,1,4,11
EYD2871,0,0,1,0,1,2,5
CKL0697,0,0,0,0,1,1,4
CIG1277,0,0,0,0,1,1,4
INB3109,0,0,0,0,1,1,4
HBM0676,0,0,0,0,1,1,4
EPH2834,0,0,1,0,1,2,5
BCH3651,0,0,1,0,1,2,5
AGB0057,1,0,0,1,1,3,10
SHG1281,0,0,0,0,1,1,4
GNT0221,1,1,1,1,1,5,13
KJC3748,0,1,1,0,1,3,7
CMR1470,0,0,0,0,1,1,4
GRP0277,0,0,0,0,1,1,4
ASC0177,0,0,0,0,1,1,4
KBM3460,0,1,1,0,1,3,7
BDP3912,0,0,1,0,1,2,5
LQJ3060,1,1,1,1,1,5,13
KTD2249,0,0,1,0,1,2,5
GDY2724,0,0,0,0,1,1,4
FDH0299,0,0,1,0,1,2,5
MAP0215,1,0,1,1,1,4,11
MOB1914,1,1,1,1,1,5,13
IMH0562,0,0,0,0,1,1,4
CIS3471,1,1,0,1,1,4,12
ETM2542,0,0,0,0,1,1,4
CTP3877,0,1,1,1,1,4,9
TCH2216,0,0,1,0,1,2,5
BFR3250,0,0,0,0,1,1,4
DRB1780,1,1,1,1,1,5,13
TBS3382,1,1,1,0,1,4,11
BWW1159,0,0,0,0,1,1,4
AAM0138,1,0,1,1,1,4,11
KHC3350,0,0,1,0,1,2,5
AAB0162,1,1,1,0,1,4,11
UWB0395,0,1,1,0,1,3,7
BKC2698,0,0,0,0,1,1,4
TGP1343,0,0,0,0,1,1,4
PEC0475,1,1,1,0,0,3,7
KAG2599,0,0,0,0,1,1,4
AIJ3995,0,0,1,0,1,2,5
CWR0117,0,0,0,0,1,1,4
VTB2147,0,0,0,0,1,1,4
KAL1210,1,1,1,0,1,4,11
LDH0574,0,0,0,0,1,1,4
HET0359,1,0,0,1,1,3,10
ZLG3090,0,0,0,0,0,0,0
BHN2290,1,1,1,1,1,5,13
USC3486,0,1,1,0,1,3,7
HIP0148,0,1,1,1,1,4,9
MRS1520,0,0,1,0,1,2,5
BCL2082,0,0,0,0,1,1,4
MCB2802,0,0,1,0,1,2,5
MAH0590,0,0,0,0,0,0,0
BLL3585,1,1,1,0,1,4,11
NMM1560,0,0,1,0,1,2,5
RLH0358,1,0,0,1,0,2,6
DDC0980,1,1,1,1,1,5,13
WJC2637,0,0,0,0,1,1,4
BJS0053,1,0,1,0,1,3,9
CID3774,1,1,1,0,1,4,11
SMM3221,0,0,0,0,1,1,4
CFL0156,1,1,1,0,1,4,11
QFD1857,0,0,0,0,1,1,4
JDB1620,0,1,1,0,1,3,7
JCC0736,1,1,1,1,1,5,13
NDM2251,0,0,1,0,0,1,1
JAM1676,0,1,1,0,1,3,7
LAF2213,0,0,1,0,1,2,5
PHA0726,1,1,1,0,1,4,11
QSG3297,0,0,1,0,1,2,5
AGC0445,1,0,0,1,1,3,10
RSE2382,0,0,0,0,1,1,4
RCH2447,1,1,1,1,1,5,13
HLZ2414,0,0,1,0,0,1,1
SGF2611,0,0,0,0,1,1,4
ASW1918,1,1,1,1,1,5,13
ROB2744,0,0,0,0,1,1,4
MWH0347,0,0,1,0,0,1,1
RQR3924,0,0,1,0,0,1,1
RAA0675,0,0,0,0,1,1,4
VSF0004,1,0,0,1,1,3,10
LIG2813,0,0,1,0,1,2,5
RJM3227,0,0,0,0,1,1,4
EQT0195,0,0,0,0,1,1,4
LRM1922,0,1,1,1,1,4,9
CBR2229,0,0,1,0,1,2,5
KBP0899,0,0,1,0,1,2,5
DWY3973,0,0,1,0,1,2,5
PDG2607,0,0,0,0,1,1,4
CLA1285,0,0,0,0,1,1,4
GKB2807,0,0,1,0,1,2,5
CAM3050,0,1,1,0,1,3,7
TZM0851,0,0,1,0,1,2,5
DSJ1384,1,1,1,0,1,4,11
DJS1127,0,0,0,0,1,1,4
JFL2674,1,1,1,1,1,5,13
SES2670,1,1,1,0,1,4,11
BRJ2151,0,0,0,0,1,1,4
FCY1157,0,0,0,0,1,1,4
STC3053,0,1,1,0,1,3,7
CNW2408,1,1,0,1,1,4,12
CKD3861,0,1,1,0,0,2,3
DOC1734,0,0,1,0,1,2,5
JJS3884,1,1,1,1,1,5,13
BGH2610,0,0,0,0,0,0,0
LIM1718,0,0,0,0,1,1,4
BDA1906,1,1,1,1,0,4,9
UMF2894,1,1,1,0,1,4,11
HEB3754,1,1,1,0,1,4,11
TDC3116,0,0,0,0,1,1,4
JGR2327,0,1,1,0,1,3,7
WET2108,0,0,0,0,1,1,4
HDC0789,0,0,0,0,1,1,4
DBS1363,1,1,1,0,1,4,11
MMS0241,0,1,1,0,1,3,7
ACS1921,0,1,1,1,1,4,9
TGH3351,0,1,1,0,1,3,7
VHM2280,1,1,1,0,1,4,11
SLC0017,1,0,0,0,1,2,8
CRL2357,0,1,1,0,1,3,7
NCT3492,0,1,1,0,1,3,7
WSE1949,0,0,0,0,1,1,4
BJR0774,0,0,0,0,1,1,4
MNB2570,1,1,1,1,1,5,13
CCT2165,0,0,1,0,1,2,5
CUL3015,0,1,1,0,1,3,7
MRE3723,0,1,1,0,1,3,7
BBV3875,1,1,1,1,1,5,13
WVM1669,1,1,1,0,1,4,11
BBM2604,0,0,0,0,1,1,4
DAL1943,1,1,1,0,1,4,11
AGM3372,1,1,1,0,1,4,11
KRD2100,0,0,0,0,1,1,4
JEH2847,0,0,1,0,1,2,5
EIH0064,1,1,1,0,1,4,11
GST1100,0,1,1,0,1,3,7
TEC2300,0,1,1,1,0,3,5
GTL3389,1,1,1,0,1,4,11
SKM1369,0,1,1,0,1,3,7
RKH1569,0,0,1,0,1,2,5
DWB3415,0,1,1,1,1,4,9
LNR0556,0,0,0,0,0,0,0
RAH1514,0,0,1,0,1,2,5
SVM0077,0,1,1,1,1,4,9
LMH3831,1,1,0,1,1,4,12
TKM1539,0,0,1,0,1,2,5
DAH3324,0,0,1,0,1,2,5
CMS0010,1,0,0,1,1,3,10
LOP1055,0,1,1,0,1,3,7
NMC3998,0,0,1,0,1,2,5
KLC3364,1,1,1,0,1,4,11
QMV2796,0,0,1,0,1,2,5
KIC2314,0,1,1,0,1,3,7
GFK3498,0,0,1,0,1,2,5
CNP1183,0,0,0,0,1,1,4
LPH3918,0,0,1,0,1,2,5
SOH3595,0,0,0,0,1,1,4
SOM2865,0,0,1,0,1,2,5
JCS0380,0,1,1,0,1,3,7
QGH0041,1,1,1,0,1,4,11
NRN2936,0,1,1,1,0,3,5
QJO1715,1,1,1,1,1,5,13
RSG2931,0,1,1,0,1,3,7
GRL2886,1,1,1,0,1,4,11
NNB2730,0,0,0,0,1,1,4
MCW3493,0,1,1,0,1,3,7
LAC0994,0,0,0,0,1,1,4
CSB1660,1,1,1,0,1,4,11
IRC3952,0,0,1,0,1,2,5
DHS2419,0,0,1,0,1,2,5
DMJ1815,0,1,1,0,1,3,7
TTF2920,1,1,1,0,1,4,11
BSS3551,0,1,1,0,1,3,7
SWK1436,0,0,0,0,1,1,4
DDW3361,1,1,1,0,1,4,11
JSM3633,0,0,1,0,1,2,5
CHB3396,0,1,1,0,1,3,7
EAH1653,1,1,1,0,1,4,11
CTM1961,0,0,0,0,1,1,4
BGR1991,0,0,0,0,1,1,4
MMW1927,1,1,1,0,1,4,11
IIM1947,1,1,1,0,1,4,11
KCR0468,0,1,1,1,1,4,9
KCH3224,0,0,0,0,1,1,4
MEC0781,0,0,0,0,0,0,0
TJM3340,0,0,1,0,1,2,5
CKM0405,1,0,1,0,1,3,9
AEK3566,0,0,0,0,1,1,4
TAP0664,0,0,0,0,1,1,4
BAW1019,0,0,1,0,1,2,5
HOE0301,0,0,1,0,1,2,5
RTM0849,0,0,1,0,1,2,5
EEH0965,1,1,1,0,1,4,11
MKR2258,0,1,1,0,1,3,7
HUC1396,0,1,1,1,1,4,9
KAP2430,1,1,1,0,1,4,11
MME3399,0,1,1,0,1,3,7
RMO2439,0,1,1,0,1,3,7
AJC0722,1,1,1,1,1,5,13
MBA2092,0,0,0,0,1,1,4
PRH2431,0,1,1,0,1,3,7
SAT3766,0,1,1,0,1,3,7
CMS1900,0,0,0,0,1,1,4
ESB2888,0,1,1,0,1,3,7
HNV3655,0,0,1,0,1,2,5
NHN0711,0,0,0,0,0,0,0
QYG1180,0,0,0,0,1,1,4
ABS0677,0,0,0,0,1,1,4
JNW2037,1,1,1,1,1,5,13
MAL2345,0,1,1,0,1,3,7
KCL2310,0,1,1,1,1,4,9
ELW1413,0,0,0,0,1,1,4
QKP3927,0,0,1,0,1,2,5
HMT1024,0,1,1,0,1,3,7
AHP0154,1,1,1,0,1,4,11
JDC3713,1,1,1,0,1,4,11
DNB3545,0,1,1,0,0,2,3
NJH0196,0,0,0,0,1,1,4
CBC0952,0,1,1,0,1,3,7
DMA3455,0,1,1,0,1,3,7
TCG1262,1,1,1,0,1,4,11
EGB3624,0,0,1,0,1,2,5
JDH0295,1,0,0,1,1,3,10
PHB0124,0,0,0,0,1,1,4
ADB3853,0,0,1,0,1,2,5
NMP3872,0,1,1,1,1,4,9
WBM1045,0,1,1,0,1,3,7
DEF0998,0,0,0,0,1,1,4
CRP2489,0,0,0,0,1,1,4
HAG3665,0,0,1,0,1,2,5
DLW2729,0,0,0,0,0,0,0
CSM2819,0,0,1,0,1,2,5
JCH2963,0,1,1,1,1,4,9
HGD1664,0,1,1,0,1,3,7
STJ2043,0,1,1,1,1,4,9
MJF0334,0,0,1,0,1,2,5
BKA0175,0,0,0,0,1,1,4
TAP1086,0,1,1,0,1,3,7
CSR3140,0,0,0,0,0,0,0
BAH1259,0,1,1,0,1,3,7
TCP2520,0,0,0,0,1,1,4
CGG2688,1,1,1,0,1,4,11
SJD3032,0,1,1,0,1,3,7
MQM1638,0,1,1,0,1,3,7
BKM3410,0,1,1,0,1,3,7
NJS2657,0,0,0,0,1,1,4
KMB3781,0,1,1,0,1,3,7
WJW3627,0,0,1,0,1,2,5
BMM0462,0,1,1,0,1,3,7
NIR3987,0,0,1,0,1,2,5
AEW1442,0,0,0,0,1,1,4
IKM1808,1,1,1,0,1,4,11
KJS1940,1,1,1,0,1,4,11
DLM2440,0,1,1,0,1,3,7
IKK3333,0,0,1,0,1,2,5
MKJ1574,0,0,1,0,1,2,5
QGS1841,0,0,0,0,1,1,4
ARJ0912,0,1,1,0,1,3,7
TDV3188,1,1,1,1,1,5,13
NRK3448,1,1,1,0,1,4,11
RHM3909,0,0,1,0,1,2,5
BMC3061,1,1,1,1,1,5,13
RPG0403,1,0,0,1,1,3,10
JHD2499,0,0,0,0,1,1,4
MNP0290,1,0,0,1,1,3,10
LCK1403,0,1,1,1,1,4,9
MBR3648,0,0,1,0,1,2,5
NHH3276,0,0,1,0,0,1,1
EKK0503,0,1,1,0,1,3,7
RCB2424,0,1,1,0,1,3,7
ADM0765,0,1,1,0,1,3,7
BAB0518,0,1,1,0,1,3,7
DCC3689,0,0,1,0,1,2,5
VBN0984,0,1,1,1,1,4,9
PAS2864,0,0,1,0,1,2,5
BOV1609,0,1,1,0,1,3,7
SCL2577,1,1,1,1,1,5,13
SCR0898,0,0,1,0,1,2,5
BCB0294,1,0,0,1,1,3,10
AAC3270,0,0,1,0,1,2,5
NHR1220,1,1,1,1,1,5,13
JHH2770,0,0,0,0,1,1,4
VNG0916,0,1,1,0,1,3,7
VJM2715,0,0,0,0,1,1,4
BCO0877,0,0,1,0,1,2,5
RTA1201,0,0,0,0,0,0,0
MSR2850,0,0,1,0,0,1,1
GDS3165,0,0,0,0,1,1,4
GVC1358,1,1,1,1,1,5,13
TJS3067,1,1,1,1,1,5,13
JKG3329,0,0,1,0,1,2,5
GRY1398,0,1,1,1,1,4,9
RNM0466,0,1,1,0,1,3,7
CQH1505,0,0,1,0,1,2,5
ADM0158,1,1,1,0,1,4,11
BHM0430,1,0,0,1,1,3,10
AUA0826,0,0,0,0,1,1,4
TDV1034,0,1,1,0,1,3,7
IJC1553,0,0,1,0,0,1,1
WGM1823,0,0,0,0,1,1,4
MNB3094,0,0,0,0,1,1,4
LBG0407,0,1,1,0,1,3,7
CHM2081,0,0,0,0,1,1,4
ACP2122,0,0,0,0,1,1,4
NBP0217,1,1,1,1,1,5,13
ROH3778,1,1,1,0,1,4,11
WES2531,0,0,0,0,1,1,4
LLG1238,1,1,1,0,1,4,11
TJL2113,0,0,0,0,1,1,4
ZHT3869,1,1,1,1,1,5,13
RHG1647,0,1,1,0,1,3,7
KAB1420,0,0,0,0,1,1,4
AED1421,0,0,0,0,1,1,4
EJG1655,0,1,1,0,1,3,7
AFB3228,0,0,0,0,1,1,4
DNM3903,1,1,1,1,1,5,13
CAC3741,0,1,1,0,1,3,7
KIC1000,1,1,1,1,1,5,13
LBW3159,0,0,0,0,1,1,4
NNJ1215,1,1,1,0,1,4,11
VNC1607,0,1,1,0,1,3,7
SIP2293,0,1,1,1,1,4,9
AJV0176,0,0,0,0,0,0,0
KNM1674,0,1,1,0,1,3,7
LIC0203,0,0,0,0,1,1,4
AJS3021,1,0,1,0,1,3,9
BAB0541,0,0,0,0,1,1,4
FFP2270,1,1,1,0,1,4,11
GDF3524,0,0,0,0,0,0,0
EJS1338,0,0,0,0,1,1,4
NJP1439,0,0,0,0,1,1,4
XKW2303,0,1,1,1,1,4,9
LCW0047,0,1,1,0,1,3,7
IKT0917,0,1,1,0,0,2,3
KRH1028,1,1,0,0,1,3,10
FZM0318,1,0,0,1,0,2,6
XCL1792,1,1,1,1,1,5,13
CMH0776,0,0,0,0,0,0,0
CBG1142,0,0,0,0,1,1,4
DHB2364,1,1,1,0,1,4,11
CAG2442,0,1,1,0,1,3,7
KEC2465,1,1,1,0,1,4,11
MCY0601,0,1,1,0,1,3,7
TKP0210,1,0,0,1,1,3,10
ZAR2140,0,0,0,0,1,1,4
ITM0906,0,0,1,0,1,2,5
LIW0379,0,1,1,0,1,3,7
TKD2115,0,0,0,0,1,1,4
CHB3647,0,0,1,0,1,2,5
MDE2114,0,0,0,0,1,1,4
QJA3887,1,1,1,1,1,5,13
LBF1992,0,0,0,0,1,1,4
APP3678,0,0,1,0,1,2,5
AKI3229,0,0,0,0,1,1,4
APS3553,1,1,1,0,1,4,11
CSE1265,0,0,0,0,1,1,4
BJM2491,0,0,0,0,1,1,4
AKW1679,0,1,1,0,1,3,7
JDC2176,0,0,1,0,1,2,5
QSG2525,0,0,0,0,1,1,4
HLO2756,0,0,0,0,1,1,4
GDM3960,0,0,1,0,1,2,5
NJS2473,1,1,1,0,1,4,11
MKC2767,0,0,0,0,1,1,4
RKE1589,1,1,1,0,1,4,11
YNR2544,0,0,0,0,0,0,0
LMH1987,0,0,0,0,1,1,4
VCR3103,0,0,0,0,1,1,4
KLM1357,1,1,1,1,1,5,13
ODB1853,0,0,0,0,1,1,4
MKO0749,1,1,1,1,1,5,13
UCM3537,0,0,0,0,1,1,4
DJA0740,0,1,1,1,1,4,9
KBV1602,0,1,1,0,1,3,7
MBL1247,0,1,1,0,1,3,7
DZW0126,0,0,0,0,1,1,4
HCH3338,0,0,1,0,1,2,5
LBM0614,0,1,1,0,0,2,3
SVM3947,0,0,1,0,1,2,5
LAO2771,0,0,0,0,1,1,4
LWH0180,0,0,0,0,1,1,4
RAH3181,0,0,0,0,0,0,0
CSM3502,0,0,1,0,1,2,5
ARP1144,0,0,0,0,1,1,4
SBJ3628,0,0,1,0,1,2,5
MCH3354,0,1,1,0,1,3,7
NGV3638,0,0,1,0,0,1,1
PDC1453,0,0,0,0,1,1,4
SNV2423,0,0,1,0,1,2,5
MNC3485,1,1,1,0,1,4,11
SBG3983,0,0,1,0,1,2,5
ZVS1637,0,1,1,0,1,3,7
ULP1169,0,0,0,0,1,1,4
CDW2000,0,0,0,0,1,1,4
ACL2943,1,1,1,1,1,5,13
YKW1763,0,1,1,0,1,3,7
OJM1324,0,0,0,0,1,1,4
SRC2524,0,0,0,0,1,1,4
XAB3746,0,1,1,0,1,3,7
EMH1957,0,0,0,0,1,1,4
WGC1081,1,1,1,0,1,4,11
ESN2683,1,1,1,0,1,4,11
WNO1466,0,0,0,0,1,1,4
WMM3904,1,1,1,1,1,5,13
CHL3430,0,1,1,1,1,4,9
CPM1627,1,1,1,0,0,3,7
BMR1662,0,1,1,0,1,3,7
TCR3994,0,0,1,0,1,2,5
BKS1860,0,0,0,0,1,1,4
REL3735,0,1,1,0,1,3,7
CHH2272,1,1,1,0,1,4,11
TJT3412,1,1,1,1,1,5,13
AHH1966,0,0,0,0,1,1,4
IRW2130,0,0,0,0,1,1,4
KKP2284,1,1,1,1,1,5,13
ANH3059,0,1,1,1,1,4,9
CTG3770,0,1,1,0,1,3,7
MHH0034,1,1,1,1,1,5,13
KRM3125,1,1,1,0,1,4,11
FSM0056,1,0,0,1,1,3,10
AKS3496,0,1,1,0,0,2,3
GAB1885,0,0,0,0,1,1,4
HCS2231,0,0,1,0,1,2,5
CKC3072,0,0,0,0,1,1,4
JSN0214,1,0,0,1,0,2,6
CBM0410,1,1,1,0,1,4,11
PLH1807,1,1,1,0,1,4,11
ACG3819,0,1,1,1,1,4,9
NIW3071,0,0,0,0,1,1,4
FPL3129,1,1,1,0,1,4,11
TCB0061,1,0,1,0,1,3,9
WGD3156,0,0,0,0,1,1,4
BLS1973,0,0,0,0,1,1,4
AHG1408,0,0,0,0,1,1,4
RMR0341,0,0,1,0,1,2,5
ATB1273,0,0,0,0,1,1,4
CKP3600,0,0,0,0,0,0,0
JJB3398,0,1,1,0,1,3,7
TSS3643,0,0,1,0,1,2,5
ACW1707,1,1,1,0,1,4,11
SHW3011,0,0,1,0,1,2,5
PTS0531,0,0,0,0,1,1,4
KNS2828,0,0,1,0,1,2,5
GVC0049,0,1,1,0,0,2,3
DLM0608,1,1,1,0,1,4,11
DCM3596,0,0,0,0,1,1,4
WNC0858,0,0,1,0,1,2,5
MSP3845,1,1,0,1,1,4,12
CDP2892,0,1,1,0,1,3,7
JCB2089,0,0,0,0,1,1,4
KBA1020,0,0,1,0,1,2,5
GJB2659,0,0,0,0,1,1,4
ACM2278,0,1,1,0,0,2,3
NPR1612,0,1,1,0,0,2,3
RIJ2470,1,1,1,0,1,4,11
RRA0643,1,1,1,1,1,5,13
GOM0090,0,1,1,0,1,3,7
LRT0447,1,1,0,1,1,4,12
ACB0701,0,0,0,0,1,1,4
NRG1562,0,0,1,0,1,2,5
LAN2608,0,0,0,0,1,1,4
HBB1759,0,1,1,0,1,3,7
CGW3093,0,0,0,0,1,1,4
KDT1190,0,0,0,0,1,1,4
CCH1724,1,1,1,1,1,5,13
SJB2984,0,1,1,0,1,3,7
SXR0964,0,1,1,0,1,3,7
NDS1897,0,0,0,0,0,0,0
GMA1698,0,1,1,0,1,3,7
RIK1631,1,1,1,0,1,4,11
SAM3862,0,1,1,0,1,3,7
SJG1194,0,0,0,0,1,1,4
NBW2810,0,0,1,0,1,2,5
RPW2445,0,1,1,1,1,4,9
RTW2758,0,0,0,0,1,1,4
BRC1811,0,1,1,0,1,3,7
NYS2040,1,1,1,1,1,5,13
POD0750,0,1,1,1,1,4,9
MNW2267,0,1,1,0,1,3,7
DYH0315,1,0,0,1,1,3,10
KCH2475,0,0,0,0,1,1,4
PIM3569,0,0,0,0,1,1,4
KSM1772,0,1,1,0,1,3,7
BTG3468,0,1,1,0,1,3,7
HCF2857,0,0,1,0,0,1,1
SLD1639,1,1,1,0,1,4,11
NNJ2986,0,1,1,0,1,3,7
WBB2321,1,1,1,0,1,4,11
KOP3802,0,1,1,1,1,4,9
HYV1658,0,1,1,0,1,3,7
IGB1902,0,0,0,0,1,1,4
SHC1585,0,1,1,0,1,3,7
GUC3945,0,0,1,0,1,2,5
LCC2503,0,0,0,0,1,1,4
KBG1117,0,1,1,0,1,3,7
DOW1266,0,0,0,0,1,1,4
CEB3714,0,1,1,0,1,3,7
HWP0364,1,0,0,1,1,3,10
CMC1642,1,1,1,0,1,4,11
RPF2614,0,0,0,0,1,1,4
LNB2991,0,1,1,0,1,3,7
SDB3500,0,0,1,0,1,2,5
QGS3009,0,0,1,0,1,2,5
ADV2467,0,1,1,0,1,3,7
LIC3646,0,0,1,0,1,2,5
ETB0828,0,0,0,0,1,1,4
CDS2792,0,0,1,0,1,2,5
JWB1519,0,0,1,0,1,2,5
ZER0085,1,1,1,0,1,4,11
KNL0918,0,1,1,0,1,3,7
MAR2386,0,0,0,0,1,1,4
NLP0155,0,1,1,0,1,3,7
WYC3397,0,1,1,0,1,3,7
COD2351,0,1,1,0,1,3,7
JSB0320,1,0,0,1,1,3,10
GMY3938,0,0,1,0,0,1,1
HAL1200,0,0,0,0,1,1,4
KEF0629,0,1,1,0,0,2,3
NKN3153,0,0,0,0,1,1,4
AKL1605,1,1,1,0,1,4,11
INR0927,0,1,1,0,1,3,7
BWA2593,0,0,0,0,1,1,4
HES2103,0,0,0,0,0,0,0
RAS0223,0,1,1,1,1,4,9
KMB1379,0,1,1,0,1,3,7
GSA2720,0,0,0,0,1,1,4
GFV3163,0,0,0,0,1,1,4
RMR2694,0,0,0,0,1,1,4
XFF1302,0,0,0,0,0,0,0
THF2879,1,1,1,0,1,4,11
RMB0885,0,0,1,0,1,2,5
DWB3085,0,0,0,0,1,1,4
HNM3405,0,1,1,0,1,3,7
UMB0055,0,0,0,0,1,1,4
ADM0923,1,1,1,0,1,4,11
WZG3563,0,0,0,0,1,1,4
SAB1954,0,0,0,0,1,1,4
XJB0548,0,0,0,0,1,1,4
RNB0519,0,1,1,0,1,3,7
ABK0481,1,1,1,1,0,4,9
KEW2795,0,0,1,0,1,2,5
ALP2955,0,1,1,1,1,4,9
KNB0560,0,0,0,0,1,1,4
DBS0880,0,0,1,0,1,2,5
CCB3055,0,1,1,0,1,3,7
WEV2867,0,0,1,0,1,2,5
REC2555,1,1,1,0,1,4,11
IHW2112,0,0,0,0,1,1,4
SGP1124,0,0,0,0,1,1,4
MAY0978,0,1,1,1,1,4,9
WAA2573,1,1,1,1,0,4,9
DBC3871,1,1,1,1,1,5,13
RRT1417,0,0,0,0,1,1,4
KCB1975,0,0,0,0,1,1,4
SJS0323,1,0,0,1,0,2,6
PLH0411,1,1,1,0,1,4,11
IMS2191,0,0,1,0,1,2,5
DSB2734,0,0,0,0,1,1,4
ACG0312,0,0,1,0,1,2,5
GSM0930,1,1,1,0,1,4,11
CBG2875,1,1,1,0,1,4,11
WAS2214,0,0,1,0,1,2,5
CHA3190,1,1,1,1,1,5,13
SRR2711,0,0,0,0,1,1,4
XIW0171,0,0,0,0,1,1,4
KPB1123,1,1,1,0,1,4,11
SKF2105,0,0,0,0,0,0,0
RJM3957,0,0,1,0,1,2,5
HBS2551,0,0,0,0,1,1,4
GES2626,0,0,0,0,1,1,4
YBJ0071,0,1,1,0,1,3,7
SME1984,0,0,0,0,1,1,4
MUH3099,0,0,0,0,1,1,4
MDM2496,0,0,0,0,1,1,4
CJM0584,0,0,0,0,0,0,0
BIT2790,0,0,1,0,1,2,5
UCW2995,0,1,1,1,1,4,9
ATC0218,1,1,1,1,1,5,13
MAM2630,0,0,0,0,1,1,4
SKB2635,0,0,0,0,1,1,4
MSB2786,0,0,1,0,1,2,5
KKS3790,0,1,1,0,1,3,7
SAR2066,0,1,1,1,1,4,9
QIC1832,0,0,0,0,1,1,4
YHB2355,0,1,1,0,1,3,7
LSM2234,0,0,1,0,1,2,5
LNK3345,0,0,1,0,1,2,5
CAM0679,0,0,0,0,1,1,4
AZA1012,0,0,0,0,1,1,4
POS0615,1,1,1,0,1,4,11
RCL0068,0,0,1,1,1,3,7
VDH0766,0,1,1,0,1,3,7
DHL2219,0,0,1,0,1,2,5
TDR0111,0,0,0,0,0,0,0
BFD1111,0,1,1,0,1,3,7
IRS1337,0,0,0,0,1,1,4
TRW3172,0,0,0,0,1,1,4
AAC0668,0,0,0,0,1,1,4
SGR1164,0,0,0,0,1,1,4
RCD2501,0,0,0,0,1,1,4
RJH3796,1,1,1,0,1,4,11
GHM3953,0,0,1,0,1,2,5
VON3443,0,1,1,0,1,3,7
PDM0304,0,0,1,0,1,2,5
SCP3664,0,0,1,0,1,2,5
TBL2581,1,1,1,1,1,5,13
LFS0392,0,1,1,0,1,3,7
MLV0088,0,1,1,0,1,3,7
JIP3170,0,0,0,0,1,1,4
BMC3636,0,0,1,0,1,2,5
VSC0775,0,0,0,0,1,1,4
ERF2472,1,1,1,0,1,4,11
WTG3411,0,1,1,1,1,4,9
CLD1641,0,1,1,0,1,3,7
FGC0114,0,0,0,0,1,1,4
FCY1819,1,1,1,0,1,4,11
VPG2530,0,0,0,0,1,1,4
SME0418,1,1,1,0,1,4,11
ATM1003,0,0,0,0,1,1,4
JMV0602,0,1,1,0,1,3,7
SZC2235,0,0,1,0,0,1,1
GPL1911,1,1,1,1,1,5,13
JIB1218,1,1,1,0,1,4,11
GSH1593,0,1,1,0,1,3,7
LRS1165,0,0,0,0,1,1,4
ADG1430,0,0,0,0,1,1,4
BHD2088,0,0,0,0,1,1,4
JDB0738,1,1,1,1,1,5,13
GLN2107,0,0,0,0,1,1,4
WRJ2184,0,0,1,0,1,2,5
KSH0672,0,0,0,0,1,1,4
SWE3155,0,0,0,0,1,1,4
QXH0396,1,1,1,0,0,3,7
RAS0356,1,0,0,1,1,3,10
CGB2215,0,0,1,0,1,2,5
CBB2904,0,1,1,0,1,3,7
MMD2022,0,0,0,0,1,1,4
MSB0830,0,0,0,0,1,1,4
NBR1873,0,0,0,0,1,1,4
RTP0754,1,1,1,1,1,5,13
ZJA2373,1,1,0,1,1,4,12
HYK3300,0,0,1,0,1,2,5
BKF2204,0,0,1,0,1,2,5
KCF0450,1,1,1,0,1,4,11
NCR2854,0,0,1,0,1,2,5
CHH3583,1,1,1,0,1,4,11
NEC2033,1,1,1,1,1,5,13
PAA2738,0,0,0,0,1,1,4
CIJ3941,0,0,1,0,1,2,5
BEH2307,0,1,1,1,1,4,9
KLD2255,0,1,1,0,0,2,3
LND2704,0,0,0,0,1,1,4
KCO0287,1,0,0,1,1,3,10
SDM3560,0,0,0,0,1,1,4
TEW0693,0,0,0,0,0,0,0
KVB3830,0,1,1,1,1,4,9
EJP2975,0,1,1,0,1,3,7
HDB1666,1,1,1,0,1,4,11
LAR0625,0,1,1,0,1,3,7
GKA3690,0,0,1,0,1,2,5
SKM1287,0,0,0,0,1,1,4
MCJ3137,0,0,0,0,1,1,4
CSM1212,1,1,1,0,1,4,11
NDW1863,0,0,0,0,1,1,4
EDJ1970,0,0,0,0,1,1,4
BLB1876,0,0,0,0,1,1,4
TDK1689,0,1,1,0,1,3,7
JHF0480,0,1,1,1,1,4,9
LOC0416,0,1,1,0,1,3,7
XEJ0773,0,0,0,0,1,1,4
JCP3883,1,1,1,1,1,5,13
BQW1904,1,1,1,1,1,5,13
FES3442,0,1,1,0,1,3,7
CCG1025,1,1,0,0,1,3,10
EGP2104,0,0,0,0,1,1,4
AMB3100,0,0,0,0,1,1,4
AGS2462,1,1,1,0,1,4,11
SWE1349,0,1,1,1,1,4,9
ASK2349,0,1,1,0,1,3,7
ACA0360,1,0,0,1,1,3,10
DHG0533,0,0,0,0,1,1,4
ZAP1762,0,1,1,0,1,3,7
NSC1939,0,1,1,0,1,3,7
MRT1855,0,0,0,0,1,1,4
KNA1279,0,0,0,0,1,1,4
BNK0087,1,1,1,0,1,4,11
MDS0759,0,1,1,0,1,3,7
CKL3556,0,0,0,0,1,1,4
BIG3946,0,0,1,0,0,1,1
UYW1162,0,0,0,0,1,1,4
MHM2370,0,1,1,0,1,3,7
MCF3187,1,1,1,1,1,5,13
SJG1510,0,0,1,0,1,2,5
ZXM3086,0,0,0,0,1,1,4
RHO0678,0,0,0,0,1,1,4
QKV2583,0,1,1,1,1,4,9
YJP2791,0,0,1,0,1,2,5
IHH2831,0,0,1,0,1,2,5
KBB0460,0,1,1,0,1,3,7
ISR1364,0,1,1,0,1,3,7
KAA2259,0,1,1,0,1,3,7
KCT3965,0,0,1,0,1,2,5
GJG1087,0,1,1,0,1,3,7
BKR3302,0,0,1,0,0,1,1
TSH3841,0,0,1,0,1,2,5
OAW3013,0,1,1,0,1,3,7
RJB1424,0,0,0,0,1,1,4
HKA0686,0,0,0,0,1,1,4
DBG3320,0,0,1,0,1,2,5
KFG2735,0,0,0,0,1,1,4
CBA1023,0,1,1,0,1,3,7
JJB1598,1,1,1,0,1,4,11
HLC0943,0,1,1,0,1,3,7
XRP3102,0,0,0,0,1,1,4
DTH1333,0,0,0,0,0,0,0
SLM2404,0,1,1,0,1,3,7
SHB3512,0,1,1,0,1,3,7
ABG3605,0,0,0,0,1,1,4
SBH3683,0,0,1,0,1,2,5
MBP1960,0,0,0,0,1,1,4
ADS2428,0,1,1,0,1,3,7
RFB2959,0,1,1,1,1,4,9
AVV2056,0,1,1,1,1,4,9
RKL2682,1,1,1,0,1,4,11
TJB2532,0,0,0,0,1,1,4
IIB2553,0,0,0,0,1,1,4
GAF2480,0,0,0,0,1,1,4
DCC2999,0,0,0,0,1,1,4
REF3266,0,0,1,0,1,2,5
TRC1831,0,0,0,0,1,1,4
JSB2942,0,1,1,1,1,4,9
SCJ2279,0,1,1,0,1,3,7
KAG0689,0,0,0,0,1,1,4
KSN3347,0,0,1,0,0,1,1
ARV0704,0,0,0,0,1,1,4
ILS0713,0,0,0,0,1,1,4
LRS1168,0,0,0,0,1,1,4
JZM1335,0,0,0,0,1,1,4
AFB1626,0,1,1,0,1,3,7
CSC0233,0,1,1,1,1,4,9
RSV3166,0,0,0,0,0,0,0
KEC0785,0,0,0,0,1,1,4
TDG2727,0,0,0,0,1,1,4
RJM0343,0,0,1,0,1,2,5
DTA2223,0,0,1,0,1,2,5
DDG0528,0,0,0,0,1,1,4
CSG1600,1,1,1,0,1,4,11
GDB2960,0,1,1,1,1,4,9
ZCR0558,0,0,0,0,1,1,4
HUM0431,1,0,0,1,1,3,10
HYF1048,0,1,1,0,1,3,7
HJH2977,0,1,1,0,1,3,7
TZG2263,0,1,1,0,1,3,7
OBH3008,0,0,0,0,1,1,4
DEY2638,0,0,0,0,1,1,4
ALB1254,1,1,1,0,0,3,7
KDT3290,0,0,1,0,1,2,5
MDM3580,0,1,1,0,1,3,7
URC3818,0,1,1,1,1,4,9
CDC3413,1,1,1,1,1,5,13
TPM3141,0,0,0,0,1,1,4
REG2171,0,0,1,0,1,2,5
DBF3635,0,0,1,0,1,2,5
WRM2803,0,0,1,0,1,2,5
CSG0135,1,0,0,1,1,3,10
TAM2031,0,1,1,1,1,4,9
ABH2671,1,1,1,1,1,5,13
RDA3381,0,1,1,0,1,3,7
RNB2679,1,1,1,0,0,3,7
DCB0401,1,0,1,0,1,3,9
KLM0714,1,1,1,1,1,5,13
KNM1154,0,0,0,0,1,1,4
ESH1283,0,0,0,0,1,1,4
EBD2562,1,1,1,0,1,4,11
NDW3217,0,0,0,0,1,1,4
VJB1699,0,1,1,0,1,3,7
BXT2678,1,1,1,1,1,5,13
TZY3133,1,1,1,0,0,3,7
NAK2784,0,0,1,0,1,2,5
NJL2478,0,0,0,0,1,1,4
AIB1567,0,0,1,0,1,2,5
LGF1503,0,0,1,0,1,2,5
NBD2469,0,1,1,0,1,3,7
ANF3332,0,0,1,0,1,2,5
JGN1767,0,1,1,0,1,3,7
GND1618,0,1,1,0,1,3,7
HLC1172,0,0,0,0,1,1,4
ALH1494,0,0,1,0,1,2,5
DIW1749,0,1,1,0,1,3,7
MLG2305,0,1,1,1,1,4,9
ADW2832,0,0,1,0,1,2,5
CSR1682,0,1,1,0,1,3,7
PSP3592,0,0,0,0,1,1,4
HMG0642,0,1,1,1,1,4,9
ZTB2410,1,0,1,0,1,3,9
CJS1986,0,0,0,0,1,1,4
BJC3423,1,1,1,1,1,5,13
RPS3617,0,0,1,0,1,2,5
LRU3765,1,1,1,0,1,4,11
DFC2060,1,1,1,1,1,5,13
FBM3728,1,1,1,0,1,4,11
SHN0104,0,0,0,0,0,0,0
OHD2274,0,1,1,0,1,3,7
DWB0865,0,0,1,0,1,2,5
URC2874,1,1,1,0,1,4,11
CQS2883,0,1,1,0,1,3,7
SSA0346,0,0,1,0,1,2,5
AVH0566,0,0,0,0,1,1,4
KSW3237,0,0,0,0,1,1,4
SCC2526,0,0,0,0,1,1,4
JCC0059,1,0,0,1,0,2,6
ALL0289,1,0,0,1,1,3,10
MCB0591,1,1,1,1,1,5,13
EKH0934,1,1,1,0,1,4,11
SCM3950,0,0,1,0,1,2,5
BMH1069,0,1,1,1,1,4,9
SAM2567,0,1,1,0,1,3,7
JBI0654,0,0,0,0,1,1,4
AJW1246,0,1,1,0,1,3,7
CAG3049,0,1,1,0,1,3,7
ILK3668,0,0,1,0,0,1,1
ADB1105,1,1,1,0,0,3,7
TAE1559,0,0,1,0,1,2,5
SJR0452,0,1,1,0,1,3,7
NLN0513,0,1,1,0,1,3,7
QAS1692,0,1,1,0,1,3,7
LRF0101,0,0,0,0,1,1,4
AIP1614,1,1,1,0,1,4,11
MMH2878,0,1,1,0,1,3,7
LDW0620,0,1,1,0,1,3,7
BOJ2179,0,0,1,0,1,2,5
KGS3466,0,1,1,0,1,3,7
YCL0650,0,0,0,0,1,1,4
WUH2238,0,0,1,0,1,2,5
DGG3429,1,1,1,1,0,4,9
KLM2448,0,1,1,1,1,4,9
RGR0706,0,0,0,0,1,1,4
RJS3256,0,0,1,0,0,1,1
SDE2662,0,0,0,0,1,1,4
MCK0435,1,0,0,1,1,3,10
RJF3634,0,0,1,0,0,1,1
RXN2265,0,1,1,0,1,3,7
ZNA0921,0,1,1,0,1,3,7
LAW1407,0,0,0,0,1,1,4
DJH0971,1,1,1,1,1,5,13
JUL1835,0,0,0,0,1,1,4
MKN3375,1,1,1,0,1,4,11
LJH2619,0,0,0,0,1,1,4
XIW2655,0,0,0,0,1,1,4
JJB2367,0,1,1,0,1,3,7
OUH0741,0,1,1,1,1,4,9
SER2158,0,0,1,0,1,2,5
HLS2733,0,0,0,0,1,1,4
JEM0546,0,0,0,0,1,1,4
RHF0046,0,1,1,0,1,3,7
MND1058,0,1,1,0,0,2,3
AAS3428,1,1,1,1,1,5,13
JRB1080,0,1,1,0,1,3,7
LCH1789,0,1,1,1,1,4,9
SSA1793,0,1,1,0,1,3,7
GWM3260,0,0,1,0,1,2,5
ACW0426,0,1,1,1,1,4,9
MEB2241,0,0,1,0,1,2,5
TTB0471,1,1,1,0,1,4,11
PSG1938,0,1,1,0,0,2,3
FVK1623,1,1,1,0,1,4,11
SHT3548,1,1,1,0,1,4,11
NEW2490,0,0,0,0,1,1,4
JSH0887,0,0,1,0,1,2,5
NNF3968,0,0,1,0,1,2,5
VZG2484,0,0,0,0,1,1,4
MAC3214,0,0,0,0,1,1,4
TAD1414,0,0,0,0,1,1,4
KSM1518,0,0,1,0,1,2,5
LXG2919,0,1,1,0,1,3,7
MCW0674,0,0,0,0,1,1,4
LXC0839,0,0,1,0,1,2,5
RDW0957,1,1,1,0,1,4,11
AKS0298,0,0,1,0,1,2,5
AMS0630,0,1,1,0,1,3,7
GYS2461,0,1,1,0,1,3,7
WPJ1400,0,1,1,1,0,3,5
REB0123,0,0,0,0,1,1,4
RCW2838,0,0,1,0,1,2,5
JLL1813,0,1,1,0,0,2,3
YSC1691,0,1,1,0,1,3,7
ASH0142,1,1,1,0,1,4,11
AAT2913,1,1,1,0,0,3,7
EUC1051,0,1,1,0,1,3,7
FNW3564,0,0,0,0,0,0,0
YFT1382,1,1,1,0,1,4,11
SDC2793,0,0,1,0,1,2,5
NHR2050,1,1,1,0,1,4,11
JSH1843,0,0,0,0,1,1,4
YAV0093,0,0,0,0,1,1,4
HIF0482,1,1,1,1,0,4,9
ARH2097,0,0,0,0,1,1,4
CCM2207,0,0,1,0,1,2,5
CJH2411,0,0,1,0,0,1,1
BMN0178,0,0,0,0,0,0,0
ING2221,0,0,1,0,1,2,5
FAR2869,0,0,1,0,1,2,5
AAG1447,0,0,0,0,1,1,4
VAC3966,0,0,1,0,1,2,5
HBC0081,0,1,1,0,0,2,3
CCH3489,1,1,0,1,1,4,12
ACH1405,0,0,0,0,1,1,4
FHM2067,0,1,1,1,1,4,9
RGP0451,0,1,1,0,1,3,7
AUR1359,0,1,1,0,1,3,7
GYO2169,0,0,1,0,1,2,5
VEB3671,0,0,1,0,1,2,5
TJB3240,0,0,0,0,1,1,4
AMJ2374,0,0,1,1,1,3,7
OWC2563,1,1,1,0,0,3,7
ZMB3863,1,1,1,1,1,5,13
CBB3018,1,1,0,1,1,4,12
JJH1389,1,1,1,1,1,5,13
PSC1608,1,1,1,0,1,4,11
CJY2951,0,1,1,1,1,4,9
PCA3212,0,0,0,0,0,0,0
CFS1611,0,1,1,0,1,3,7
BPL3202,0,0,0,0,1,1,4
GNA0183,0,0,0,0,1,1,4
SCL0022,1,0,0,1,1,3,10
FZW2101,0,0,0,0,1,1,4
JDB0956,1,1,1,0,1,4,11
GAB1206,1,1,1,0,1,4,11
NEH3435,1,1,1,1,1,5,13
BAH3684,0,0,1,0,1,2,5
EUH0257,0,0,0,0,1,1,4
TKS3035,0,1,1,0,1,3,7
BMH0457,1,1,1,0,0,3,7
LUG2205,0,0,1,0,1,2,5
ROA3171,0,0,0,0,0,0,0
PVV3999,0,0,1,0,0,1,1
CKB3745,1,1,1,0,1,4,11
WAC3677,0,0,1,0,1,2,5
VCS1196,0,0,0,0,1,1,4
ORM1484,0,0,1,0,1,2,5
LRC3160,0,0,0,0,1,1,4
CLC1272,0,0,0,0,1,1,4
SSH1649,1,1,1,0,1,4,11
VCF3273,0,0,1,0,1,2,5
KPP2253,1,1,1,0,1,4,11
ERH0815,0,0,0,0,1,1,4
NSC0237,0,1,1,1,1,4,9
MNM1161,0,0,0,0,1,1,4
KDM3923,0,0,1,0,1,2,5
IDF0189,0,0,0,0,1,1,4
GRM3793,1,1,1,0,1,4,11
AMB3208,0,0,0,0,1,1,4
BKC3473,1,1,1,0,1,4,11
GMM0224,0,0,1,1,1,3,7
PJS2078,0,0,0,0,1,1,4
ROH1347,1,1,1,1,1,5,13
BGN3820,0,1,1,1,1,4,9
MHG3749,0,1,1,0,1,3,7
FAH1851,0,0,0,0,1,1,4
ADB0350,1,0,0,1,1,3,10
KBC1485,0,0,1,0,0,1,1
MMC0261,0,0,0,0,0,0,0
GNH1735,0,1,1,0,1,3,7
REC0283,1,0,0,1,1,3,10
DDL3007,0,0,0,0,1,1,4
RTN3680,0,0,1,0,1,2,5
RAB2739,0,0,0,0,1,1,4
LRW1502,0,0,1,0,1,2,5
JGH0493,0,1,1,0,1,3,7
IIG0772,0,0,0,0,1,1,4
JBP0651,0,0,0,0,1,1,4
TDW1746,0,0,1,0,1,2,5
MCO3164,0,0,0,0,1,1,4
DNS1768,1,1,1,0,1,4,11
WCR2136,0,0,0,0,0,0,0
KCS3465,0,1,1,0,1,3,7
LAH3026,0,1,1,0,0,2,3
ACV1946,1,1,1,0,1,4,11
CXK3433,1,1,1,1,1,5,13
JMM0848,0,0,1,0,1,2,5
CIG3459,0,1,1,0,1,3,7
MHS1146,0,0,0,0,1,1,4
DTT1716,0,1,1,1,1,4,9
ZVB2656,0,0,0,0,1,1,4
HRF2044,1,1,1,0,1,4,11
HQB0118,0,0,0,0,1,1,4
RSV2438,0,1,1,0,1,3,7
KWB1967,0,0,0,0,1,1,4
LBG3911,0,0,1,0,1,2,5
ILH2989,0,1,1,0,1,3,7
TPM0039,0,1,1,0,1,3,7
CKB0596,1,1,1,1,1,5,13
NHH1704,1,1,0,1,1,4,12
ACB3123,1,1,1,0,1,4,11
QRJ1597,1,1,1,0,1,4,11
JLM3150,0,0,0,0,1,1,4
JCM1388,1,1,1,0,1,4,11
ZBW1015,0,0,0,0,1,1,4
BJH3294,0,0,1,0,1,2,5
SSF3031,0,1,1,0,1,3,7
WJH0717,1,1,1,1,1,5,13
ZAC1838,0,0,0,0,1,1,4
NDG3403,0,1,1,0,1,3,7
BJV2631,0,0,0,0,1,1,4
NDR1456,0,0,0,0,1,1,4
LCR1537,0,0,1,0,1,2,5
ATF3708,0,0,1,0,0,1,1
BKM1155,0,0,0,0,1,1,4
DSM3954,0,0,1,0,1,2,5
TSL2699,0,0,0,0,1,1,4
HHD2393,0,0,0,0,1,1,4
HJA0779,0,0,0,0,1,1,4
DBR1558,0,0,1,0,0,1,1
GLC3495,0,0,1,0,1,2,5
MCM2375,0,1,1,1,1,4,9
MJS0832,0,0,0,0,1,1,4
CRC2747,0,0,0,0,1,1,4
JRM2358,0,1,1,0,1,3,7
HHL2311,0,1,1,1,1,4,9
ACM0100,0,0,0,0,1,1,4
NJM0173,0,0,0,0,1,1,4
ELC1833,0,0,0,0,1,1,4
RHA3613,0,0,1,0,1,2,5
BHE1709,0,1,1,0,1,3,7
VMW1500,0,0,1,0,1,2,5
QBH3579,1,1,1,0,1,4,11
ISM0130,1,0,1,0,1,3,9
GAN1584,1,1,1,0,1,4,11
MTL3695,0,0,1,0,1,2,5
GDR1066,1,1,1,1,1,5,13
SMS1114,0,1,1,0,1,3,7
HUM2481,0,0,0,0,1,1,4
LKS1416,0,0,0,0,1,1,4
UAH3940,0,0,1,0,1,2,5
GMK1449,0,0,0,0,1,1,4
CDD0127,0,0,0,0,1,1,4
JSG3377,0,1,1,0,1,3,7
KTL2843,0,0,1,0,1,2,5
YKM2435,0,1,1,0,1,3,7
HMM2841,0,0,1,0,1,2,5
TOS3712,1,1,1,0,1,4,11
BLN0230,1,1,1,0,1,4,11
WHW2777,0,0,1,0,0,1,1
RME2477,0,0,0,0,1,1,4
BKM2643,0,0,0,0,1,1,4
HWS2915,1,1,1,0,0,3,7
NIB1197,0,0,0,0,1,1,4
AGL1301,0,0,0,0,1,1,4
CBR0121,0,0,0,0,1,1,4
NCA3027,0,1,1,0,1,3,7
GKL1516,0,0,1,0,1,2,5
JLW3598,0,0,0,0,1,1,4
RJS3479,0,0,1,0,1,2,5
DSA3620,0,0,1,0,1,2,5
JSB1535,0,0,1,0,1,2,5
JGM3588,1,1,1,0,1,4,11
FDD3893,0,1,1,1,1,4,9
ARL2672,1,1,1,0,1,4,11
CJW0376,0,1,1,0,1,3,7
CFR1166,0,0,0,0,0,0,0
CBJ0683,0,0,0,0,0,0,0
CSL2055,1,1,1,0,1,4,11
EBH1882,0,0,0,0,1,1,4
PTR2613,0,0,0,0,1,1,4
NCS3577,1,1,1,0,1,4,11
QLC0082,1,1,1,0,1,4,11
JEH2787,0,0,1,0,1,2,5
IAS0857,0,0,1,0,1,2,5
EJG0833,0,0,0,0,1,1,4
KBF2661,0,0,0,0,1,1,4
SGP2174,0,0,1,0,1,2,5
MJD0469,1,1,1,0,1,4,11
AAR0641,1,1,1,1,1,5,13
GLR3888,1,1,1,1,1,5,13
YSG1195,0,0,0,0,1,1,4
SCP1116,0,1,1,0,1,3,7
ZND2154,0,0,1,0,1,2,5
MRC2160,0,0,1,0,1,2,5
APP2488,0,0,0,0,1,1,4
GKH1634,0,1,1,0,1,3,7
JAO3463,0,1,1,0,1,3,7
UCS3454,0,1,1,0,1,3,7
KDN0264,0,0,0,0,1,1,4
GCM0813,0,0,0,0,1,1,4
AIC1071,0,1,1,1,1,4,9
ABH1181,0,0,0,0,1,1,4
BDL1065,1,1,1,1,1,5,13
DLP1445,0,0,0,0,1,1,4
CBM1814,0,1,1,0,1,3,7
LUK1182,0,0,0,0,1,1,4
KBO2485,0,0,0,0,1,1,4
VTD2731,0,0,0,0,1,1,4
LGL2772,0,0,0,0,1,1,4
DJF0760,1,1,1,0,1,4,11
EAH2882,0,1,1,0,1,3,7
JEW2141,0,0,0,0,1,1,4
CHB0996,0,0,0,0,1,1,4
JIR2827,0,0,1,0,1,2,5
CMD0613,0,1,1,0,1,3,7
RCM1372,0,1,1,0,1,3,7
LCC1963,0,0,0,0,1,1,4
TNR0319,1,0,0,1,1,3,10
MJR0244,0,1,1,0,1,3,7
GOG3939,0,0,1,0,1,2,5
GPB2691,0,1,1,0,1,3,7
JSM3334,0,0,1,0,1,2,5
RSA2941,1,1,1,1,0,4,9
ACR0331,1,0,0,1,1,3,10
NJR1714,0,0,0,0,1,1,4
KWR1544,0,0,1,0,1,2,5
MDB0680,0,0,0,0,1,1,4
AWB2282,0,1,1,0,1,3,7
KVW0814,0,0,0,0,1,1,4
MRE0567,0,0,0,0,1,1,4
WXM3698,0,0,1,0,1,2,5
XAL0414,0,1,1,0,1,3,7
MAH2095,0,0,0,0,1,1,4
DRC2296,0,1,1,1,1,4,9
JRJ0919,0,1,1,0,0,2,3
CDP0340,0,0,1,0,1,2,5
IRT2811,0,0,1,0,1,2,5
IWB3257,0,0,1,0,1,2,5
OLB2930,0,1,1,0,1,3,7
GNC2237,0,0,1,0,1,2,5
NVH3726,1,1,1,0,1,4,11
RJB1151,0,0,0,0,1,1,4
HMM2628,0,0,0,0,1,1,4
AVH2360,0,1,1,0,1,3,7
ALB3649,0,0,1,0,1,2,5
HCH3685,0,0,1,0,1,2,5
DHR2541,0,0,0,0,1,1,4
CMM3702,0,0,1,0,1,2,5
BXK2091,0,0,0,0,1,1,4
CAP2149,0,0,0,0,1,1,4
CMM1068,0,1,1,1,1,4,9
CCB3173,0,0,0,0,1,1,4
TWW0811,0,0,0,0,1,1,4
OLA2686,0,1,1,0,1,3,7
HAP3000,0,0,0,0,1,1,4
OZH2737,0,0,0,0,1,1,4
KCC2434,0,1,1,0,1,3,7
MMA1255,0,1,1,0,1,3,7
JOB1328,0,0,0,0,1,1,4
AXW3243,0,0,0,0,1,1,4
GAB3758,1,1,1,0,1,4,11
JCM1803,0,1,1,0,1,3,7
QWL3474,0,0,0,0,1,1,4
BON0968,0,1,1,1,1,4,9
TKS1549,0,0,1,0,1,2,5
AUI2464,0,1,1,0,1,3,7
PNH1444,0,0,0,0,1,1,4
WYC2416,0,1,1,0,1,3,7
SGW0443,1,0,0,1,1,3,10
CKM0508,1,1,1,0,0,3,7
APB3823,1,1,1,1,1,5,13
GCD1189,0,0,0,0,1,1,4
CWB1463,0,0,0,0,1,1,4
ANC1319,0,0,0,0,1,1,4
AEP1930,1,1,1,1,1,5,13
IJM3356,1,1,1,0,1,4,11
CJG3002,0,0,0,0,1,1,4
DJP2420,0,0,1,0,0,1,1
EAB2522,0,0,0,0,1,1,4
RGB1869,0,0,0,0,1,1,4
KND0529,0,0,0,0,1,1,4
SMH1953,0,0,0,0,1,1,4
GJG0852,0,0,1,0,1,2,5
XBK2623,0,0,0,0,1,1,4
KDC2976,0,1,1,0,1,3,7
SHH0970,0,1,1,1,1,4,9
EMS1736,1,1,1,0,1,4,11
LAB1297,0,0,0,0,1,1,4
AMR0197,0,0,0,0,1,1,4
TAM1488,0,0,1,0,1,2,5
VDI1217,0,1,1,1,0,3,5
SBO3115,0,0,0,0,1,1,4
ASF1136,0,0,0,0,1,1,4
SAC0374,1,0,1,0,0,2,5
JMF3362,0,1,1,0,0,2,3
RWH3312,0,0,1,0,1,2,5
NMV2556,1,1,1,0,1,4,11
UMS0883,0,0,1,0,1,2,5
VEC1686,1,1,1,0,1,4,11
AWV0836,0,0,0,0,0,0,0
TSF3478,0,0,0,0,1,1,4
CHY0083,0,1,1,0,1,3,7
YDM2537,0,0,0,0,0,0,0
GDP1856,0,0,0,0,1,1,4
JSW0872,0,0,1,0,1,2,5
KMS0954,0,1,1,0,1,3,7
MCT0424,1,1,1,1,1,5,13
RAA1455,0,0,0,0,1,1,4
WBA1786,1,1,1,1,1,5,13
FRM3431,0,1,1,1,1,4,9
QIT3029,0,1,1,0,1,3,7
CGW0692,0,0,0,0,1,1,4
MNN1167,0,0,0,0,1,1,4
LGR1036,0,0,1,0,1,2,5
DDH1041,0,1,1,0,1,3,7
CRP1186,0,0,0,0,1,1,4
QHF3151,0,0,0,0,1,1,4
ADM2762,0,0,0,0,1,1,4
HIS1706,0,1,1,1,1,4,9
BRW3552,1,1,1,0,1,4,11
GIH0882,0,0,1,0,1,2,5
ISM2612,0,0,0,0,0,0,0
JJE1552,0,0,1,0,1,2,5
GHD1450,0,0,0,0,1,1,4
CUM2335,0,1,1,0,1,3,7
AHC0232,0,1,1,0,1,3,7
TBM3829,0,1,1,1,1,4,9
JBT1035,0,0,1,0,0,1,1
CHU3211,0,0,0,0,1,1,4
AAP0352,1,0,0,1,1,3,10
THB0987,1,1,0,1,1,4,12
ABD3426,1,1,1,1,1,5,13
KCS0605,1,1,1,0,1,4,11
DPF3360,0,1,1,0,0,2,3
MRL2636,0,0,0,0,1,1,4
MYW0914,0,1,1,0,0,2,3
KUS2137,0,0,0,0,1,1,4
WFN0926,1,1,1,0,1,4,11
ABM3641,0,0,1,0,1,2,5
ABO1173,0,0,0,0,1,1,4
RSE2181,0,0,1,0,1,2,5
DND3309,0,0,1,0,1,2,5
CZB3718,0,1,1,0,1,3,7
RBP1171,0,0,0,0,0,0,0
SRL3525,0,0,0,0,1,1,4
BHC2049,1,1,1,1,1,5,13
LKF0335,0,0,1,0,0,1,1
JEP1571,0,0,1,0,0,1,1
XBH0357,1,0,0,1,1,3,10
IBP1616,0,1,1,0,1,3,7
AEH2020,0,0,0,0,1,1,4
NBN2651,0,0,0,0,1,1,4
GNG2362,0,1,1,0,1,3,7
GEB3079,0,0,0,0,1,1,4
JJM3791,0,1,1,0,1,3,7
MHS2634,0,0,0,0,1,1,4
DLM1680,0,1,1,0,1,3,7
WCM3134,1,1,1,0,1,4,11
KSJ0840,0,0,1,0,1,2,5
BCO2338,0,1,1,0,1,3,7
JBW3852,0,0,1,0,1,2,5
DDS3149,0,0,0,0,1,1,4
LMG1061,0,1,1,0,1,3,7
EJM2690,0,1,1,0,1,3,7
KJD3392,0,1,1,0,1,3,7
EBC3242,0,0,0,0,1,1,4
CTJ0669,0,0,0,0,1,1,4
DOS1990,0,0,0,0,1,1,4
CSP0483,1,1,1,1,1,5,13
NEA3248,0,0,0,0,1,1,4
MRH2722,0,0,0,0,0,0,0
HLM1007,0,0,0,0,1,1,4
MOS0496,0,1,1,0,1,3,7
NDK3436,1,1,1,1,1,5,13
SMR0338,0,0,1,0,1,2,5
DNB1999,0,0,0,0,1,1,4
BMS0925,0,1,1,0,1,3,7
RRM2175,0,0,1,0,1,2,5
LHG3145,0,0,0,0,1,1,4
NQM0084,0,1,1,0,1,3,7
JFO2840,0,0,1,0,1,2,5
ASD3348,0,0,1,0,1,2,5
DRS0032,1,1,0,1,1,4,12
GNE1365,1,1,1,0,1,4,11
AJO2788,0,0,1,0,1,2,5
CTB3481,0,0,1,0,1,2,5
GNW3891,1,1,1,1,1,5,13
WCB0801,0,0,0,0,1,1,4
JMH0617,1,1,1,0,1,4,11
SAP3390,0,1,1,0,1,3,7
LEB1764,0,1,1,0,1,3,7
KTR3308,0,0,1,0,1,2,5
YNW2855,0,0,1,0,1,2,5
MBH1370,1,1,1,0,1,4,11
MCC0856,0,0,1,0,1,2,5
LCP0344,0,0,1,0,1,2,5
ISR1477,0,0,0,0,1,1,4
MJM3657,0,0,1,0,1,2,5
JSR1085,1,1,1,0,1,4,11
TJB3511,1,1,1,0,1,4,11
NWO3501,0,1,1,0,0,2,3
XTB3322,0,0,1,0,0,1,1
GKN0168,0,0,0,0,1,1,4
HKR2901,0,1,1,0,1,3,7
AHS2348,1,1,1,0,1,4,11
PEB3768,1,1,1,0,1,4,11
KDA1452,0,0,0,0,1,1,4
AIS1082,0,1,1,0,1,3,7
BJM3236,0,0,0,0,0,0,0
DCB3597,0,0,0,0,0,0,0
GCJ0831,0,0,0,0,0,0,0
GEB3975,0,0,1,0,1,2,5
FCS1128,0,0,0,0,1,1,4
DBC1152,0,0,0,0,1,1,4
MBN3610,0,0,0,0,1,1,4
WBC1203,0,0,0,0,1,1,4
GCR2597,0,0,0,0,1,1,4
SMH2222,0,0,1,0,1,2,5
VLF1113,1,1,1,0,1,4,11
BNC1497,0,0,1,0,1,2,5
BPR1678,0,1,1,0,0,2,3
WAJ2412,0,1,1,0,1,3,7
HMB0805,0,0,0,0,1,1,4
MLW0296,0,0,1,0,1,2,5
CIV0935,0,1,1,0,1,3,7
SHM2429,0,1,1,0,1,3,7
DWC2994,1,1,0,1,1,4,12
TCG0016,1,0,0,0,1,2,8
BWC2534,0,0,0,0,0,0,0
PEV3955,0,0,1,0,1,2,5
KKB2094,0,0,0,0,1,1,4
SIW2528,0,0,0,0,1,1,4
LBM2142,0,0,0,0,1,1,4
AIF1202,0,0,0,0,1,1,4
AGW1590,0,1,1,0,1,3,7
JIM2988,0,1,1,0,1,3,7
HJG3868,1,1,1,1,1,5,13
AGL3519,1,1,1,0,1,4,11
CSR3225,0,0,0,0,1,1,4
CTH0737,0,1,1,1,1,4,9
KNC3843,0,0,1,0,1,2,5
SGK1941,1,1,1,0,1,4,11
CNK1711,0,0,0,0,1,1,4
QNC3717,1,1,1,0,1,4,11
JAW3813,0,1,1,1,1,4,9
KHC2129,0,0,0,0,1,1,4
BEG3521,0,0,0,0,1,1,4
AJN1275,0,0,0,0,1,1,4
CAS1702,0,1,1,0,1,3,7
RHL0268,0,0,0,0,1,1,4
NSW3199,1,1,1,1,1,5,13
VJC1974,0,0,0,0,1,1,4
CAH1839,0,0,0,0,1,1,4
CAC0147,0,0,1,1,1,3,7
KDH1284,0,0,0,0,1,1,4
PTS2487,0,0,0,0,0,0,0
KCG0979,1,1,1,1,1,5,13
MMB0185,0,0,0,0,1,1,4
BRW0963,1,1,1,0,1,4,11
JSH3019,1,1,0,1,1,4,12
AGF0742,1,1,1,1,1,5,13
ADG1737,0,1,1,0,1,3,7
DWD2621,0,0,0,0,1,1,4
HDH3751,0,1,1,0,1,3,7
ANC1834,0,0,0,0,1,1,4
CSR0612,0,1,1,0,1,3,7
AKG2702,0,0,0,0,1,1,4
YZC3244,0,0,0,0,1,1,4
YMB2953,1,1,1,1,1,5,13
SRH3590,1,1,1,0,1,4,11
BSS2956,0,1,1,1,1,4,9
JUG0498,0,1,1,0,0,2,3
PSS2051,1,1,1,1,1,5,13
BSM2288,1,1,1,1,1,5,13
CPP2909,1,1,1,0,0,3,7
SWA1824,0,0,0,0,1,1,4
HVR0633,0,1,1,1,1,4,9
LCG0784,0,0,0,0,1,1,4
DCM3288,0,0,1,0,1,2,5
GKG2763,0,0,0,0,1,1,4
CAM2468,1,1,1,0,1,4,11
BPM3694,0,0,1,0,1,2,5
LMJ3535,0,0,0,0,1,1,4
JOR2627,0,0,0,0,1,1,4
VND1667,0,1,1,0,1,3,7
GIM0786,0,0,0,0,1,1,4
JLG2952,0,1,1,1,1,4,9
AIA2005,0,0,0,0,0,0,0
MBB2649,0,0,0,0,1,1,4
ZJS2648,0,0,0,0,0,0,0
MIA3825,0,1,1,1,1,4,9
NJW2402,1,1,1,0,1,4,11
SEN0534,0,0,0,0,1,1,4
HHW2471,1,1,1,0,1,4,11
LLG2958,1,1,1,1,1,5,13
IOM0542,0,0,0,0,1,1,4
XBL3922,0,0,1,0,1,2,5
FZS0969,0,1,1,1,1,4,9
UDB1170,0,0,0,0,1,1,4
TNH3028,0,1,1,0,0,2,3
SSS3091,0,0,0,0,1,1,4
HZM3056,0,1,1,1,1,4,9
NNM2862,0,0,1,0,1,2,5
GRL3110,0,0,0,0,1,1,4
BCC0456,0,1,1,0,1,3,7
CAR0928,0,1,1,0,1,3,7
NEB3445,1,1,1,0,0,3,7
DBT0141,0,1,1,1,1,4,9
SKP3263,0,0,1,0,1,2,5
JOA0305,0,0,1,0,1,2,5
MQR1657,0,1,1,0,1,3,7
AWH2466,1,1,1,0,0,3,7
KBO2708,0,0,0,0,1,1,4
JCC1381,0,1,1,0,1,3,7
RDB1693,0,1,1,0,1,3,7
CGC1132,0,0,0,0,1,1,4
MJS3720,1,1,1,0,0,3,7
DAD2620,0,0,0,0,1,1,4
WDD0499,0,1,1,0,1,3,7
BEA0311,0,0,1,0,1,2,5
JDV1245,1,1,1,0,1,4,11
APP1054,0,1,1,0,0,2,3
BCM3794,0,1,1,0,1,3,7
MHV1529,0,0,1,0,1,2,5
WJC0470,1,1,1,1,1,5,13
NTP2146,0,0,0,0,1,1,4
ERC1840,0,0,0,0,1,1,4
HMY0235,1,1,1,1,1,5,13
KEF1057,0,1,1,0,1,3,7
TAM3048,0,1,1,0,1,3,7
GMH2027,0,0,0,0,0,0,0
LCM1480,0,0,0,0,1,1,4
PAM0505,1,1,1,0,1,4,11
UMH1532,0,0,1,0,1,2,5
KNS0539,0,0,0,0,1,1,4
RIS2436,0,1,1,0,1,3,7
RMB2275,0,1,1,0,1,3,7
BBF2388,0,0,0,0,1,1,4
IMR3660,0,0,1,0,1,2,5
SML1923,1,1,1,0,1,4,11
MSF3311,0,0,1,0,1,2,5
BBH3779,0,1,1,0,1,3,7
CAR2900,0,1,1,0,1,3,7
JCH3456,0,1,1,0,1,3,7
TSD2948,1,1,1,1,1,5,13
JCR3919,0,0,1,0,1,2,5
BXW1804,0,1,1,0,0,2,3
CRC0348,0,0,1,0,1,2,5
DAH2506,0,0,0,0,0,0,0
HCS2401,0,1,1,0,1,3,7
CBS0951,0,1,1,0,0,2,3
SHP1713,0,0,0,0,1,1,4
IRB2456,1,1,1,1,1,5,13
GJM2800,0,0,1,0,1,2,5
XJM3874,1,1,1,1,1,5,13
SCR2455,1,1,1,1,1,5,13
JJC0116,0,0,0,0,0,0,0
KSB1599,0,1,1,0,1,3,7
THG3271,0,0,1,0,1,2,5
SWS0823,0,0,0,0,1,1,4
BCZ1345,1,1,1,1,0,4,9
BMB0007,1,0,0,1,1,3,10
AZB1225,0,1,1,1,1,4,9
HLM1564,0,0,1,0,1,2,5
HQF1912,1,1,1,1,1,5,13
AGM0133,1,0,0,1,1,3,10
JZE2902,0,1,1,0,0,2,3
VAB1102,0,1,1,0,1,3,7
PIG2047,1,1,1,0,1,4,11
JRB0025,1,0,0,1,1,3,10
RAW3461,0,1,1,0,1,3,7
DXM2433,0,1,1,0,1,3,7
AYS0110,0,0,0,0,1,1,4
GWC0137,1,0,0,1,1,3,10
MEA3886,1,1,1,1,1,5,13
LYF3449,1,1,1,0,1,4,11
KAA2150,0,0,0,0,1,1,4
WLG0406,0,1,1,0,1,3,7
HMP3391,1,1,1,0,1,4,11
JEL2887,0,1,1,0,1,3,7
ZBW0132,0,0,0,0,1,1,4
HKH0204,0,0,0,0,1,1,4
CHF1005,0,0,0,0,1,1,4
ZAN1931,0,1,1,1,1,4,9
CWF1289,0,0,0,0,1,1,4
OMB2053,1,1,1,0,1,4,11
MSW0973,0,1,1,1,1,4,9
OEJ1648,0,1,1,0,1,3,7
AYL1635,0,1,1,0,1,3,7
OGW3384,1,1,1,0,1,4,11
RKA2561,1,1,1,0,1,4,11
BCB2072,0,1,1,1,1,4,9
CMA1475,0,0,0,0,1,1,4
WAF3438,0,1,1,1,1,4,9
IJC3881,1,1,1,1,1,5,13
RJH0219,1,1,1,1,1,5,13
AKS3705,0,0,1,0,1,2,5
RKH3803,0,1,1,1,1,4,9
JIW2086,0,0,0,0,1,1,4
PGM0342,0,0,1,0,1,2,5
ELB3697,0,0,1,0,1,2,5
DMM2063,0,1,1,1,0,3,5
EZP3568,0,0,0,0,1,1,4
JMH2517,0,0,0,0,1,1,4
MMJ0070,0,0,1,0,1,2,5
DMG1298,0,0,0,0,1,1,4
YJP2689,0,1,1,0,1,3,7
GHT3177,0,0,0,0,1,1,4
CJM0273,0,0,0,0,1,1,4
FAP0199,0,0,0,0,1,1,4
FNM2124,0,0,0,0,1,1,4
HMS2212,0,0,1,0,1,2,5
BNF1110,1,1,1,0,1,4,11
RMD0792,0,0,0,0,1,1,4
ISH0079,0,1,1,0,1,3,7
BSV1499,0,0,1,0,1,2,5
SFM2226,0,0,1,0,1,2,5
JTR3205,0,0,0,0,1,1,4
MNW1733,0,0,1,0,1,2,5
SKK0282,1,0,0,1,1,3,10
IMH2964,0,1,1,0,1,3,7
GJO3614,0,0,1,0,1,2,5
WAR1374,1,1,1,0,1,4,11
NTH2822,0,0,1,0,1,2,5
AIL2511,0,0,0,0,1,1,4
CWH0038,0,1,1,0,1,3,7
IBP2990,1,1,1,0,1,4,11
LJM3339,0,0,1,0,0,1,1
VMN0743,1,1,1,1,1,5,13
DWF2268,0,1,1,0,1,3,7
MTG0463,0,1,1,0,1,3,7
JPC2507,0,0,0,0,0,0,0
IWR3469,0,1,1,0,0,2,3
AEB3249,0,0,0,0,1,1,4
LHB3089,0,0,0,0,1,1,4
RDC0378,0,1,1,0,1,3,7
XWM0415,0,1,1,0,1,3,7
HHF1995,0,0,0,0,1,1,4
AAP1942,1,1,1,0,1,4,11
IRO0822,0,0,0,0,1,1,4
RVL1688,0,1,1,0,1,3,7
YJD3130,1,1,1,0,1,4,11
MDG3281,0,0,1,0,1,2,5
CRP3682,0,0,1,0,1,2,5
CMH3077,0,0,0,0,1,1,4
YBP3978,0,0,1,0,1,2,5
OLH3452,0,1,1,0,1,3,7
MRM2906,0,1,1,0,1,3,7
KDT3773,1,1,1,0,1,4,11
FBM2755,0,0,0,0,1,1,4
ZDC2523,0,0,0,0,1,1,4
RGB0263,0,0,0,0,1,1,4
BJE0351,1,0,0,1,0,2,6
CBC3175,0,0,0,0,1,1,4
GTG1348,1,1,1,1,1,5,13
VKA1118,0,1,1,0,1,3,7
LOC1446,0,0,0,0,1,1,4
JRR2745,0,0,0,0,1,1,4
JHB0807,0,0,0,0,0,0,0
CTD1850,0,0,0,0,1,1,4
LJH0866,0,0,1,0,1,2,5
CMM0764,0,1,1,0,1,3,7
AMD2728,0,0,0,0,1,1,4
SGC2111,0,0,0,0,1,1,4
BAR3420,1,1,1,1,0,4,9
DCC1431,0,0,0,0,1,1,4
JYW1965,0,0,0,0,1,1,4
OHM1030,0,1,1,0,1,3,7
WKC0573,0,0,0,0,1,1,4
ZDC3269,0,0,1,0,1,2,5
FFP3169,0,0,0,0,1,1,4
AJQ0809,0,0,0,0,1,1,4
CBM0060,1,0,0,1,1,3,10
AMN0911,0,1,1,0,1,3,7
LWB2851,0,0,1,0,1,2,5
QMP2998,0,0,0,0,1,1,4
BJG0662,0,0,0,0,1,1,4
OUJ2510,0,0,0,0,1,1,4
DCW0174,0,0,0,0,1,1,4
LKS1010,1,1,1,1,1,5,13
SLH0900,0,0,1,0,1,2,5
ALH2916,1,1,1,0,1,4,11
GDH3546,1,1,1,0,1,4,11
BAL2366,0,1,1,0,1,3,7
BHW2476,0,0,0,0,1,1,4
CDB2017,0,0,0,0,1,1,4
BNB3370,1,1,1,0,1,4,11
NWH2896,0,1,1,0,1,3,7
LKB2322,0,1,1,0,1,3,7
OWL2872,0,0,1,0,1,2,5
KCO1253,0,1,1,0,1,3,7
ZZO2997,1,1,1,0,1,4,11
DJF3394,0,1,1,0,1,3,7
LSM0408,1,1,1,0,1,4,11
RME0448,0,1,1,0,1,3,7
AJC3010,0,0,1,0,1,2,5
BRR2899,0,1,1,0,1,3,7
OIP0988,0,0,1,1,1,3,7
VHG3993,0,0,1,0,1,2,5
DSN3186,1,1,1,1,1,5,13
SNC1837,0,0,0,0,1,1,4
HCB1383,0,1,1,0,1,3,7
GJS0160,0,1,1,0,1,3,7
IAB3386,0,1,1,0,1,3,7
MRB0796,0,0,0,0,1,1,4
BCS1604,0,1,1,0,1,3,7
CCT0020,1,0,0,1,1,3,10
TLK0003,1,0,0,1,1,3,10
IBM1752,0,0,1,0,1,2,5
GIT2266,0,1,1,0,1,3,7
LYB3419,0,1,1,1,1,4,9
MKR1339,0,0,0,0,1,1,4
IIW0361,1,0,0,1,1,3,10
BNC3178,0,0,0,0,1,1,4
SJS1415,0,0,0,0,1,1,4
NBH3076,0,0,0,0,1,1,4
EMM3195,0,1,1,1,0,3,5
QRR1242,0,1,1,0,1,3,7
MHS0125,0,0,0,0,1,1,4
BXN0660,0,0,0,0,1,1,4
SJL3355,0,1,1,0,1,3,7
BNT0663,0,0,0,0,1,1,4
RKM3650,0,0,1,0,1,2,5
AJS0616,0,1,1,0,1,3,7
ZOM0746,1,1,1,1,1,5,13
GJT1292,0,0,0,0,1,1,4
BLD2227,0,0,1,0,1,2,5
JLF3219,0,0,0,0,0,0,0
